Lance de flammes	Огненное копье
Effigie	Чучело
Héros défunt	Павший герой
Déflagration des Arcanes	Чародейская вспышка
Métamorphose : sanglier	Превращение в вепря
Aspirant de Dalaran	Боец из Даларана
Jette-sorts	Чаромет
Drake de Frimarra	Дракон Хладарры
Rhonin	Ронин
Dompteur de béliers	Пастух
Championne sacrée	Святая защитница
Rejeton des Ombres	Исчадие теней
Mot de pouvoir : Gloire	Слово силы: Слава
Ombrefiel	Исчадие Тьмы
Convertir	Обращение
Confusion	Замешательство
Gardien du Crépuscule	Сумеречный страж
Confesseur d’argent Paletress	Исповедница Пейлтресс
Destrier de l’effroi	Конь погибели
Garde funeste effroyable	Грозный демон
Minuscule chevalier maléfique	Малый рыцарь зла
Poing de Jaraxxus	Кулак Джараксуса
Écraseur du Vide	Крушитель из Бездны
Fusion démoniaque	Демоническая сила
Sombre marché	Темная сделка
Garde-courroux	Страж гнева
Wilfred Flopboum	Вилфред Непопамс
Chevaucheur pandashan	Всадник Шадо-Пан
Boucanier	Буканьер
Vaillant de Fossoyeuse	Рыцарь Подгорода
Vide-gousset	Карманник
Marchand douteux	Сомнительный делец
Larcin	Воришка
Lame empoisonnée	Отравленное лезвие
Embusqué	Из-под земли
Anub’arak	Ануб'арак
Racines vivantes	Живые корни
Aspirante de Darnassus	Боец из Дарнаса
Combattant sauvage	Яростный воин
Marcheuse sauvage	Дикая странница
Chevalier des étendues sauvages	Рыцарь чащи
Druidesse du Sabre	Друид-саблезуб
Communion astrale	Астральное единение
Charpie	Мульчирование
Aviana	Авиана
Rohart totémique	Клыкарр-шаман
Grave-totem draeneï	Резчица тотемов
Vague de soins	Волна исцеления
Vaillant des Pitons-du-Tonnerre	Рыцарь Громового Утеса
Marteau chargé	Магический молот
Destruction élémentaire	Разрушительные стихии
Golem totémique	Тотемный голем
Savoir ancestral	Древнее знание
Le mandebrume	Призыватель туманов
Soins rapides	Быстрое исцеление
Tir puissant	Мощный выстрел
Maître des écuries	Главный конюх
Elekk du roi	Королевский элекк
Brave archère	Храбрая лучница
Piège à ours	Медвежья ловушка
Prêt à tirer	На изготовку!
Boule d’araignées	Паучий клубок
Gueule-d’acide	Кислотная Утроба
Écaille-d’effroi	Жуткая Чешуя
Sonner	Оглушить
Défenseur du roi	Королевский поборник
Aspirant d’Orgrimmar	Боец из Оргриммара
Magnataure alpha	Вожак магнатавров
Renforcement	Усиление
Partenaire d’entraînement	Спарринг-партнер
Cap’taine céleste Kragg	Крагг Поднебесный
Championne d’Alexstrasza	Защитница Алекстразы
Varian Wrynn	Вариан Ринн
Esprit combatif	Боевой настрой
Sceau des champions	Печать чемпионов
Maître des chevaux de guerre	Боевой берейтор
Chevalier murloc	Мурлок-рыцарь
Lance d’Argent	Серебряное копье
Entrée dans le Colisée	Вход в Колизей
Adversaire mystérieux	Загадочный претендент
Commandant du fief	Командир гарнизона
Eadric le Pur	Эдрик Чистый
Modeste écuyer	Скромный оруженосец
Chevaucheur de faucon-dragon	Всадник на дракондоре
Porte-lance	Копьеносец
Damoiselle du Lac	Озерная дева
Saboteur	Саботажник
Cavalier d’Argent	Серебряный всадник
Champion de Mogor	Защитник Могора
Lieutenant de la garde d’os	Костяной лейтенант
Champion de Mukla	Защитник Муклы
Médecin du tournoi	Лекарь турнира
Enragé de glace	Ледяной яростень
Frigbold algide	Морозный снобольд
Jongleur de flammes	Жонглер пламенем
Chevalier silencieux	Молчаливый рыцарь
Chevalier mécanique	Заводной рыцарь
Spectateur du tournoi	Зритель турнира
Mangesort prodigieuse	Глотательница чар
Chevaucheuse de kodo	Всадница на кодо
Régente de la Main d’argent	Паладин-регент
Combattante de la fosse	Боец арены
Jormungar capturé	Пленный йормунгар
Kraken de la mer Boréale	Кракен Северного моря
Jouteur rohart	Бретер-клыкарр
Kvaldir blessé	Раненый квалдир
Champion de la Lumière	Защитник Света
Cheval de guerre cuirassé	Бронированный скакун
Guetteur d’Argent	Серебряный дозорный
Régisseur du Colisée	Распорядитель Колизея
Vendeur de rafraîchissements	Продавец закусок
Maître jouteur	Великий бретер
Recruteur	Вербовщик
Provocateur maléfique	Злобный насмешник
Maître d’escrime	Учитель фехтования
Agent du Repos du ver	Драконий посланник
Maîtresse de cérémonie	Церемониймейстер
Grande croisée	Великий рыцарь
Écumeur kvaldir	Квалдир-налетчик
Géant du givre	Ледяной великан
Favori de la foule	Кумир толпы
Gormok l’Empaleur	Гормок
Frissegueule	Ледяная Пасть
Bolf Bélier-Frondeur	Болф Таранный Щит
Glace-Hurlante	Ледяной Рев
Champion du Nexus Saraad	Сараад, рыцарь Нексуса
Le chevalier squelette	Рыцарь-скелет
Fjola Plaie-lumineuse	Фьола Погибель Света
Saccageur des mers	Гроза морей
Eydis Plaie-sombre	Эйдис Погибель Тьмы
Justicière Cœur-Vrai	Мариэль Чистосердечная
Jouteuse de Gadgetzan	Бретер из Прибамбасска
Veille solennelle	Священное бдение
Attise-flammes	Поджигатель
Souffle du dragon	Дыхание дракона
Dragonnet du Crépuscule	Сумеречный дракончик
Courroux démoniaque	Демонический гнев
Chef du gang des diablotins	Главарь банды бесов
Recrutement	Сходка
Furtif sombrefer	Тихоступ Черного Железа
Lourdaud volcanique	Вулканический древень
Druidesse de la Flamme	Друид пламени
Horion de lave	Лавовый шок
Destructeur garde du feu	Огнестраж-разрушитель
Tir réflexe	Скорострельность
Rageur du Magma	Яростень Недр
Revanche	Возмездие
Lanceur de hache	Метатель топоров
Ressusciter	Воскрешение
Dragon consort	Супруга дракона
Client sinistre	Мрачный завсегдатай
Sorcier draconien	Драконор-чародей
Œuf de dragon	Яйцо дракона
Écraseur drakônide	Драконид-сокрушитель
Drake volcanique	Вулканический дракон
Dragon affamé	Голодный дракон
Chambellan Executus	Мажордом Экзекутус
Empereur Thaurissan	Император Тауриссан
Rend Main-Noire	Ренд Чернорук
Nefarian	Нефариан
Chromaggus	Хромаггус
Technicienne de l’Aile noire	Техник Крыла Тьмы
Corrupteur de l’Aile noire	Губитель Крыла Тьмы
Raza l’Enchaîné	Раза Плененный
Potion de gel	Зелье заморозки
Monte-en-l’air mécanique	Заводной воробот
Cache d’armes	Схрон
Entourloupeur des bas-fonds	Уличный фокусник
Wyrm de mana rouge	Алый маназмей
Eauracle jinyu	Говорящий с водой
Protecteur des Dessoudeurs	Защитник трущоб
Chimiste fou	Чокнутый химик
Baron Boule-de-Gras	Толстосум
Potion volcanique	Вулканическое зелье
Laquais de la Kabale	Прихвостень «Кабала»
Soigneur hozen	Хозен-лекарь
Potion de gangrefeu	Зелье огня Скверны
Fouine perce-tunnels	Пронырливая ласка
Maîtresse des mélanges	Мастерица микстур
Avocat commis d’office	Адвокат
Cavale de contrebandier	Незаконный ввоз
Kun, le roi oublié	Кун, Забытый Король
Quatre murlocs et un enterrement	Мурлоковороты
Chef de jade	Нефритовый вождь
Mon précieux	Было ваше, стало наше!
Chat de gouttière	Бродячий кот
Le clan des rats	Крысиная стая
Informateur des bas-fonds	Осведомитель из трущоб
Regard de nacre	Млечноокий
Boucanier de petite envergure	Мелкий буканьер
Organisatrice de combats	Организатор боев
Phalanges	Кулакс
Caisse de contrebandier	Контрабандный товар
Kodo de livraison	Патрульный кодо
Porte-flingue secoué	Самопальщик
Lance-piranha	Пиранострел
Enrage-bête trogg	Трогг-погонщик
Sergent Sally	Сержант Салли
Boucanier porte-grigris	Удачливый буканьер
Béhémoth de jade	Нефритовое чудище
Bourbinja, l’étoile volante	Мурлиндзя
Idole de jade	Нефритовый идол
Potion de folie	Зелье безумия
Potion de soins supérieure	Среднее лечебное зелье
Agent drakônide	Драконид-шпион
Géode de mana	Мановая жеода
Potion de cristal explosif	Зелье взрыв-кристалла
Âmefiel gangr’orc	Душегуб Скверны
Tisse-cristal	Заклинатель кристаллов
Potion rougefurie	Зелье кровавой ярости
Marque du Lotus	Знак «Лотоса»
Puissance chapardée	Кража силы
Rêveuse céleste	Небесная провидица
Chimiste de la Kabale	Химик «Кабала»
Potion de métamorphose	Зелье превращения
Kazakus	Казакус
Projectiles des Arcanes majeurs	Чародейские суперстрелы
Prêtre de la serre de la Kabale	Жрец Когтя из «Кабала»
Pièce contrefaite	Фальшивая монетка
Coup de poing en laiton	Латунный кастет
Assassin du Lotus	Убийца из «Лотоса»
Enragé d’ombre	Яростень Тьмы
Neunœil le pirate	Пират Глазастик
Massacreur des Dessoudeurs	Громила из трущоб
Hobart Martelutte	Хобарт Дрек
Lépreux occulte	Лепрогном из подворотни
Sniper souffle-branchie	Снайпер Свистожабрых
Racketteur de haut vol	Матерый гангстер
Messagère de la Kabale	Курьер «Кабала»
Affranchi sinistrécaille	Живец Темной Чешуи
Corsaire naga	Нага-корсар
Cogneur médiocre	Второсортный костолом
Flingueur	Наемник
Barman amical	Радушный трактирщик
Limon d’égout toxique	Токсичный слизнюк
Enquêteur perspicace	Уличный детектив
Vole-chant de la Kabale	Песнекрад «Кабала»
Videur de l’arrière-salle	Вышибала
Mondaine de Gadgetzan	Светская львица
Incante-âme démente	Заклинательница душ
Potion réductrice	Гномозелье
Potion de feu draconique	Зелье драконьего огня
Trafiquante de la Kabale	Перевозчица «Кабала»
Motard worgen	Ворген-стиляга
Maître de grouk-fu	Мастер грук-фу
Experte en déminage	Подрывница
Gangsters, hé ho !	Доппельгангстер
Caïd cambrioleur	Вороватый задира
Maire Brouillecaboche	Мэр Гогельмогель
Cryomancienne	Криомантка
Madame Goya	Мадам Гойя
Don Han’Cho	Дон Хан'Чо
Maître des encres Solia	Каллиграф Солия
Motard huran	Шипастый хряк
Shuriken de jade	Нефритовый сюрикэн
Grouillant de jade	Нефритовый роевик
Passeur de Gadgetzan	Паромщик
Sensei de l’ombre	Сенсей Тьмы
Dévolution	Инволюция
Illusionniste du Lotus	Иллюзионистка «Лотоса»
Piqueur de démons des mers	Морской дьявол
Éclair de jade	Нефритовая молния
Floraison de jade	Нефритовый цветок
Esprit de jade	Нефритовый дух
Nourrir les poissons	На корм рыбам
Griffes de jade	Нефритовые когти
Krul le Déchaîné	Крул Освобожденный
Massacreur abyssal	Могучий абиссал
Marchandises volées	Чужое добро
Outilleur des Dessoudeurs	Торговец из трущоб
Gadgétiseur des Dessoudeurs	«Бугай»-технарь
Usurière des Dessoudeurs	Ростовщица из трущоб
Armurière clandestine	Уличная бронница
Marshal malhonnête	Страж порядка
Livre-cristaux de la Kabale	Разносчица кристаллов
Shaku, le Collectionneur	Шаку Собиратель
Rat déloyal	Грязная крыса
Kodo de cavale	Побег на кодо
Irion	Гневион
Commissaire-priseur Beardo	Аукционист Вихлюн
Genzo, le Requin	Шулер Гензо
Chopper huran de Tanaris	Турбохряк из Танариса
Chef hurane vêtue de cuir	Главарь «Ночных хряков»
Visions lunaires	Лунные видения
Barbefeu Tresse-Flammes	Сенопал Огнеус
Sensei virmen	Гну-синь-сенсей
Journaliste intrépide	Бесстрашный репортер
Agents du Lotus	Агенты «Лотоса»
Contrebandière des bas-fonds	Контрабандистка
Ancien des floraisons	Древо цветения
Nettoyeur défias	Ликвидатор из Братства
Apothicaire clandestin	Подпольный аптекарь
Aya Patte Noire	Айя Черная Лапа
Recrues à la petite semaine	Мелкие сошки
Je connais un gars	Я знаю кое-кого
Soldat de Comté-de-l’Or	Солдат Златоземья
Rampant des tourbières	Трясинный ползун
Nova sacrée	Кольцо света
Contrôle mental	Контроль разума
Feu intérieur	Внутренний огонь
Châtiment sacré	Божественная кара
Vision télépathique	Внутреннее зрение
Mot de pouvoir : Bouclier	Слово силы: Щит
Griffe	Коготь
Toucher guérisseur	Целебное касание
Éclat lunaire	Лунный огонь
Marque du fauve	Знак дикой природы
Rugissement sauvage	Дикий рев
Balayage	Размах
Croissance sauvage	Буйный рост
Métamorphose	Превращение
Intelligence des Arcanes	Интеллект чародея
Éclair de givre	Ледяная стрела
Explosion des Arcanes	Чародейский взрыв
Nova de givre	Кольцо льда
Image miroir	Зеркальные копии
Blizzard	Снежная буря
Boule de feu	Огненный шар
Javelot de glace	Ледяное копье
Choc de flammes	Волна огня
Élémentaire d’eau	Элементаль воды
Horion de givre	Ледяной шок
Esprit ancestral	Дух предков
Furie des vents	Неистовство ветра
Guérison ancestrale	Исцеление предков
Élémentaire de feu	Элементаль огня
Arme croque-roc	Камнедробитель
Furie sanguinaire	Жажда крови
Double vue	Дальнее зрение
Trait de l’ombre	Стрела Тьмы
Diablotin de sang	Кровавый бес
Drain de vie	Похищение жизни
Flammes infernales	Адское пламя
Corruption	Порча
Infernal de l’effroi	Жуткий инфернал
Marcheur du Vide	Демон Бездны
Attaque sournoise	Удар в спину
Sang froid	Хладнокровие
Poison mortel	Смертоносный яд
Attaque pernicieuse	Коварный удар
Assassiner	Ликвидация
Sprint	Спринт
Lame d’assassin	Клинок убийцы
Marque du chasseur	Метка охотника
Bénédiction de puissance	Печать могущества
Gardien des rois	Защитник королей
Lumière sacrée	Свет небес
Justice de la Lumière	Правосудие Света
Bénédiction des rois	Печать королей
Consécration	Освящение
Marteau de courroux	Молот гнева
Championne en vrai-argent	Серебряный клинок
Charge	Рывок
Saccager	Буйство
Frappe héroïque	Удар героя
Hache de guerre embrasée	Огненная секира
Exécution	Казнь
Faucheuse en arcanite	Арканитовый жнец
Enchaînement	Рассекающий удар
Prophète du Cercle terrestre	Служитель Земли
Enragé du magma	Магмовый яростень
Gueule d’acier des oasis	Оазисный хрустогрыз
Crocilisque des rivières	Речной кроколиск
Grunt loup-de-givre	Боец Северного Волка
Chef de raid	Лидер рейда
Chevaucheur de loup	Всадник на волке
Grizzly Ferpoil	Гризли-сталемех
Patriarche dos-argenté	Седоспин-патриарх
Chevalier de Hurlevent	Рыцарь Штормграда
Fusilier de Forgefer	Ружейник Стальгорна
Géomancien kobold	Кобольд-геомант
Matelot des mers du Sud	Матрос Южных морей
Inventrice gnome	Гном-изобретатель
Commando foudrepique	Дворф-диверсант
Champion de la Main d’argent	Рыцарь Длани
Archimage	Верховный маг
Assassin de Ravenholdt	Скрытный убийца
Seigneur de l’arène	Повелитель арены
Écumeur murloc	Мурлок-налетчик
Jeune faucon-dragon	Молодой дракондор
Sanglier brocheroc	Вепрь-камнеклык
Raptor Rougefange	Ящер Кровавой Топи
Guerrier branchie-bleue	Воин Синежабрых
Maître-bouclier de Sen’jin	Щитоносец Сен'джин
Maître-lame blessé	Раненый рубака
Yéti noroît	Морозный йети
Golem de guerre	Боевой голем
Garde de Baie-du-Butin	Гоблин-телохранитель
Sergent grossier	Бранящийся сержант
Archère elfe	Эльфийская лучница
Chasseuse de Tranchebauge	Охотница на Иглошкурых
Ogre-magi	Огр-маг
Ogre rochepoing	Огр Тяжелого Кулака
Chien du Magma	Гончая Недр
Chouette bec-de-fer	Железноклюв
Missilière téméraire	Шальная ракетчица
Forgeron malveillant	Зловещий кузнец
Champion de Hurlevent	Герой Штормграда
Chef de guerre loup-de-givre	Вождь Северного Волка
Nervi de la KapitalRisk	Алчный наемник
Feu follet	Огонек
Protecteur Écorcefer	Сторожевое древо
Déluge de lames	Шквал клинков
Mot de l’ombre : Douleur	Слово Тьмы: Боль
Clerc de Comté-du-Nord	Клирик Североземья
Esprit divin	Божественный дух
Busard affamé	Голодный канюк
Soigneuse sombrécaille	Нага-целительница
Maître-chien	Псарь
Loup des bois	Лесной волк
Rhino de la toundra	Тундровый люторог
Flèches multiples	Залп
Pistage	Выслеживание
Tir des Arcanes	Чародейский выстрел
Arc long du gladiateur	Длинный лук
Attaque mentale	Взрыв разума
Gardelumière	Стражница Света
Le Chevalier noir	Черный рыцарь
Jeune prêtresse	Молодая жрица
Chasseur de gros gibier	Опытный охотник
Robot d’alarme	Тревого-бот
Acolyte de la souffrance	Служитель боли
Écuyère d’Argent	Сквайр Авангарда
Poulet furieux	Злая курица
Infiltrateur worgen	Ворген-разведчик
Docteur vaudou	Знахарь вуду
Mage de sang Thalnos	Маг крови Талнос
Roi Mukla	Король Мукла
Ingénieur novice	Инженер-новичок
Sylvanas Coursevent	Сильвана Ветрокрылая
Panthère de la jungle	Тропическая пантера
Clerc du Soleil brisé	Священник син'дорай
Croisée écarlate	Алый крестоносец
Long-voyant de Thrallmar	Провидец Траллмара
Garde de Lune-d’argent	Страж Луносвета
Mécano de petit dragon	Дракономеханик
Tigre de Strangleronce	Тигр Тернистой долины
Gnome lépreux	Лепрогном
Marche-soleil	Служительница солнца
Harpie Furie-des-vents	Неистовая гарпия
Drake du Crépuscule	Сумеречный дракон
Aventurier en pleine quête	Авантюрист
Guetteur ancien	Древний дозорный
Nain sombrefer	Дворф Черного Железа
Brise-sort	Разрушитель чар
Jeune maître brasseur	Молодой хмелевар
Oracle froide-lumière	Вайш'ирский оракул
Accro au mana	Любительница маны
Ancien maître brasseur	Старый хмелевар
Protectrice solfurie	Заступница син'дорай
Alchimiste dément	Безумный алхимик
Vieux Troublœil	Старый Мрачноглаз
Limon des marais acide	Кислотный слизнюк
Commandant d’Argent	Командир Авангарда
Minuscule invocatrice	Гном-призыватель
Gardienne des secrets	Хранительница тайн
Bombardier fou	Чокнутый подрывник
Suprétincelle	Мехмастер Замыкалец
Officier chanteguerre	Командир Песни Войны
Contrôleur mental	Ментальный техник
Golem arcanique	Чародейский голем
Prêtresse de la Cabale	Жрица Тьмы
Défenseur d’Argus	Защитник Аргуса
Commissaire-priseur	Гоблин-аукционист
Amasseur de butin	Собиратель сокровищ
Abomination	Поганище
Chroniqueur Cho	Хранитель истории Чо
Démolisseur	Разрушитель
Voyant froide-lumière	Вайш'ирский провидец
Géant des montagnes	Горный великан
Cairne Sabot-de-Sang	Кэрн Кровавое Копыто
Gelbin Mekkanivelle	Гелбин Меггакрут
Leeroy Jenkins	Лирой Дженкинс
Éviscération	Потрошение
Trahison	Предательство
Dissimuler	Замаскировать
Éventail de couteaux	Веер клинков
Noble sacrifice	Самопожертвование
Meneur défias	Главарь Братства
Œil pour œil	Око за око
Lame de la perdition	Клинок вечных мук
Agent du SI:7	Агент ШРУ
Rédemption	Искупление
Casse-tête	Черепокол
Pas de l’ombre	Шаг сквозь тень
Préparation	Подготовка
Colère	Гнев
Marque de la nature	Знак природы
Âme de la forêt	Душа леса
Puissance du fauve	Сила дикой природы
Acclimatation	Близость к природе
Loup alpha redoutable	Вожак лютых волков
Nourrir	Дар природы
Druide de la Griffe	Друид когтя
Gardien du bosquet	Хранитель чащи
Innervation	Озарение
Cobra empereur	Императорская кобра
Feu stellaire	Звездный огонь
Ancien de la guerre	Древо войны
Éclair	Молния
Explosion de lave	Выброс лавы
Diable de poussière	Пыледемон
Puissance totémique	Сила тотемов
Horion de terre	Земной шок
Maléfice	Сглаз
Hache de Forge-foudre	Топор бури
Esprit farouche	Дух дикого волка
Baron Geddon	Барон Геддон
Élémentaire de terre	Элементаль земли
Fourche d’éclairs	Раздвоенная молния
Élémentaire délié	Вольный элементаль
Tempête de foudre	Гроза
Arcaniste éthérien	Эфириал-чародей
Cône de froid	Конус холода
Projectiles des Arcanes	Чародейские стрелы
Kriss	Отравляющий укол
Explosion pyrotechnique	Огненная глыба
Élémentaire de givre	Ледяной элементаль
Drake azur	Лазурный дракон
Contresort	Антимагия
Barrière de glace	Ледяная преграда
Entité miroir	Отраженная сущность
Bloc de glace	Ледяная глыба
Ragnaros, seigneur du feu	Рагнарос
Gangregarde	Страж Скверны
Voile de mort	Лик тлена
Ombreflamme	Пламя Тьмы
Terreur du Vide	Ужасень Бездны
Succube	Суккуб
Feu de l’âme	Ожог души
Siphonner l’âme	Вытягивание души
Garde funeste	Страж ужаса
Néant distordu	Круговерть Пустоты
Seigneur des abîmes	Владыка преисподней
Portail d’invocation	Портал призыва
Puissance accablante	Переполняющая мощь
Détection des démons	Чутье на демонов
Diablotin des flammes	Огненный бес
Plaie funeste	Бич судьбы
Seigneur Jaraxxus	Лорд Джараксус
Silence	Немота
Folie de l’ombre	Темное безумие
Rejeton de lumière	Порождение Света
Vol d’esprit	Украденные мысли
Puits de lumière	Колодец Света
Jeux d’esprit	Игры разума
Faveur divine	Божественная милость
Prophète Velen	Пророк Велен
Imposition des mains	Возложение рук
Bénédiction du champion	Благословение силы
Humilité	Смирение
Protecteur d’Argent	Заступник Авангарда
Bénédiction de sagesse	Печать мудрости
Colère divine	Гнев небес
Épée de justice	Меч справедливости
Main de protection	Длань защиты
Repentir	Покаяние
Garde-paix de l’Aldor	Миротворец Алдоров
Tirion Fordring	Тирион Фордринг
Courroux vengeur	Гнев карателя
Guerrier tauren	Таурен-воин
Heurtoir	Мощный удар
Rage du combat	Боевая ярость
Berserker amani	Аманийский берсерк
Gardien mogu’shan	Стражник Могу'шан
Fabricante d’armes	Оружейница Арати
Berserker gurubashi	Берсерк Гурубаши
Tourbillon	Вихрь
Fabricante d’armures	Мастер брони
Porte-bouclier	Щитоносец
Baston	Потасовка
Frappe mortelle	Смертельный удар
Amélioration !	Улучшение
Heurt de bouclier	Мощный удар щитом
Hurlesang	Кровавый вой
Worgen déchaîné	Разъяренный ворген
Grommash Hurlenfer	Громмаш Адский Крик
Chasse-marée murloc	Мурлок-волнолов
Chef de guerre murloc	Мурлок-полководец
Oracle sinistrécaille	Оракул Темной Чешуи
Mande-flots murloc	Мурлок-волномут
Assassin patient	Терпеливый убийца
Hyène charognarde	Гиена-падальщица
Détournement	Перенаправление
Grande crinière des savanes	Высокогрив саванны
Arc cornedaigle	Лук Орлиного рога
Tir explosif	Разрывной выстрел
Lâcher les chiens	Спустить собак
Ordre de tuer	Команда «Взять!»
Roi Krush	Король Круш
Fusée éclairante	Осветительная ракета
Courroux bestial	Звериный гнев
Piège à serpents	Змеиная ловушка
Golem des moissons	Уборочный голем
Nat Pagle	Нат Пэгл
Harrison Jones	Харрисон Джонс
Archimage Antonidas	Архимаг Антонидас
Nozdormu	Ноздорму
Alexstrasza	Алекстраза
Onyxia	Ониксия
Malygos	Малигос
Manipulateur sans-visage	Безликий манипулятор
Totem Langue de feu	Тотем языка пламени
Marteau-du-Destin	Молот Рока
Morsure	Укус
Force de la nature	Сила природы
Ysera	Изера
Cénarius	Кенарий
Totem de vague de mana	Тотем прилива маны
La Bête	Чудовище
Sauvagerie	Дикость
Assommer	Ошеломление
Mage de Dalaran	Маг Даларана
Prêtresse d’Élune	Жрица Элуны
Mage ancien	Древний маг
Géant des mers	Морской великан
Parlevent	Говорящий с ветром
Chevalier de sang	Рыцарь крови
Prêtresse auchenaï	Аукенайская жрица
Lamenuit	Ночной Клинок
Vaporisation	Обращение в пар
Maître de culte	Глава культа
Feu démoniaque	Демонический огонь
Maître des diablotins	Владычица бесов
Sous-chef cruel	Злой надсмотрщик
Berserker écumant	Разъяренный берсерк
Maîtrise du blocage	Блок щитом
Rage intérieure	Внутренняя ярость
Apprentie du sorcier	Ученица чародея
Tir de précision	Снайперский выстрел
Piège explosif	Взрывная ловушка
Piège givrant	Морозная ловушка
Mage du Kirin Tor	Маг Кирин-Тора
Edwin VanCleef	Эдвин ван Клиф
Illidan Hurlorage	Иллидан Ярость Бури
Âme en peine de mana	Магический призрак
Tir meurtrier	Смертельный выстрел
Égalité	Равенство
Géant de lave	Огненный великан
Cercle de soins	Круг исцеления
Mot de l’ombre : Mort	Слово Тьмы: Смерть
Massacreur du temple	Храмовый боец
Flammes sacrées	Священный огонь
Forme d’Ombre	Облик Тьмы
Dissipation de masse	Массовое рассеивание
Croq’zombie	Вкусный зомби
Rampante hantée	Одержимый ползун
Limon résonnant	Делящийся слизнюк
Savant fou	Безумный ученый
Ombre de Naxxramas	Тень Наксрамаса
Œuf de nérubien	Нерубское яйцо
Chevalier spectral	Призрачный рыцарь
Seigneur de la mort	Владыка Смерти
Maexxna	Мексна
Tisseuse	Тенетник
Crache-vase	Изрыгатель слизи
Kel’Thuzad	Кел'Тузад
Stalagg	Сталагг
Feugen	Фойген
Âme gémissante	Стенающая душа
Seigneur de la toile nérub’ar	Властелин паутины
Dupliquer	Раздвоение
Graines de poison	Ядовитые семена
Venger	Отмщение
Morsure de la mort	Укус смерти
Implorateur du Vide	Призыватель Бездны
Sombre sectateur	Темный сектант
Goule instable	Нестабильный вурдалак
Réincarnation	Возрождение
Embusqué anub’ar	Неруб-душитель
Gargouille peau-de-pierre	Каменная горгулья
Fossoyeur	Могильщик
Épées dansantes	Танцующие клинки
Horreb	Лотхиб
Baron Vaillefendre	Барон Ривендер
Canon lance-flammes	Огненная пушка
Souffle-neige	Снегочух
Portail instable	Нестабильный портал
Explomage gobelin	Гоблин-взрывомаг
Écho de Medivh	Эхо Медива
Méca-téléporteur	Механосборщик
Léviathan des flammes	Огненный левиафан
Bombe de lumière	Световая бомба
Bombardière d’ombre	Теневой бомбардир
Choix de Velen	Избранник Велена
Réducteur fou	Уменьшайстер
Lumière des naaru	Свет Наару
Maître des rouages	Мастер шестеренок
Vol’jin	Вол'джин
Bombe de matière noire	Темная бомба
Saccageur gangrené	Сквернобот
Appel du familier	Призыв питомца
Maîtresse de Douleur	Госпожа Боли
Cœur de démon	Сердце демона
Gangrecanon	Пушка Скверны
Mal’Ganis	Мал'Ганис
Huile d’affûtage de Bricoleur	Оружейное механомасло
Robot barbier gobelin	Авто-брадобрей
Clé de maître des rouages	Гаечный ключ
Tricheur borgne	Одноглазый плут
Feindre la mort	Притвориться мертвым
Sensei de fer	Железный сенсей
Prince marchand Gallywix	Принц Галливикс
Appel des ancêtres	Зов предков
Ourson robot anodisé	Ржавый медвежонок
Recyclage	Переработка
Sylvenier du Bosquet	Хранительница рощи
Arbre de vie	Древо Жизни
Méca chat-ours	Механо-медвекот
Malorne	Малорн
Masse de puissance	Палица силы
Zap-o-matic tournoyant	Крутящийся меченосец
Crépitement	Разряд
Totem de vitalité	Тотем жизни
Marche-esprit aileron vaseux	Мурлок-духостранник
Sombres feux follets	Мрачный огонек
Neptulon	Нептулон
Glaivezooka	Метатель глеф
Char araignée	Танк-паук
Éruption de diablotins	Бес-пощадный взрыв
Roi des bêtes	Царь зверей
Sabotage	Диверсия
Bondisseur dent-de-métal	Железнозубый прыгун
Gahz’rilla	Газ'рилла
Lame rebondissante	Прыгучий сюрикэн
Robo-baston	Боевой робот
Écraser	Сокрушение
Vierge guerrière	Защитница
Cogneguerre ogre	Боевой молот огров
Cliquetteur perce-vrille	Ржавый голем
Mastodonte de fer	Железный исполин
Sceau de Lumière	Печать Света
Mini-robot blindé	Защищенный мини-бот
Rouage-marteau	Зубцевик
Intendant	Интендант
Régiment de bataille	Призыв в бой
Gardien de cobalt	Кобальтовый страж
Bolvar Fordragon	Болвар Фордрагон
Saute-flaque	Грязевик
Brute ogre	Огр-громила
Chaman cognedune	Огр-шаман
Trogg brisepierre	Трогг Камнедробов
Trogg mâcheroc mastoc	Трогг Каменной Челюсти
Robot de soins antique	Древний исцелятор
Mataf	Просоленный моряк
Haut-trotteur égaré	Заблудившийся долгоног
Boxeur de l’ombre	Теневой боксер
Tir du cobra	Выстрел кобры
Mystique de Kezan	Мистик Кезана
Canon du navire	Корабельная пушка
Mouton explosif	Взрывоопасная овца
Golem d’anima	Голем Анимуса
Yéti mécanique	Механический йети
Char de force MAX	Силовой танк
Druide du Croc	Друид-змея
Traqueur gloubelin	Жаблин-ловец
Gnome mécanique	Заводной гном
Robot réparateur amélioré	Ремонтный супербот
Machine volante	Ветролет
Ennuy-o-tron	Раздражатор
Engin de siège	Осадная машина
Sniper de Gentepression	Снайпер из картеля
Ninja ogre	Огр-ниндзя
Illuminatrice	Просветительница
Bombardier cinglé	Ошалевший подрывник
Annulateur d’Arcane X-21	Чудо-обнулятор X-21
Expérimentateur gnome	Гном-экспериментатор
Cible leurre	Манекен-мишень
Jeeves	Дживс
Sapeur gobelin	Гоблин-сапер
Déchiqueteur piloté	Пилотируемый крошшер
Mini exorciste	Юный экзорцист
Infanterie de Gnomeregan	Пехотинец Гномрегана
Lobe-Bombe	Бомбометатель
Guetteur flottant	Парящий страж
Purificateur écarlate	Освятитель Алого ордена
Technicien de Brikabrok	Гном-техник
Micro-machine	Микроробот
Hobgobelin	Хобгоблин
Golem céleste piloté	Небесный голем
Brik-à-bot	Хламобот
Mécano-amplificateur	Механо-усилитель
Recombobulateur	Рекомбинатор
Mini-mage	Мини-маг
Dr Boum	Доктор Бум
Tête de Mimiron	Голова Мимирона
Mogor l’ogre	Огр Могор
Faucheur 4000	Врагорез-4000
Vieux déchiqueteur de Sneed	Старый крошшер Снида
Toshley	Тошли
Mekgénieur Thermojoncteur	Анжинер Термоштепсель
Gazleu	Газлоу
Troggzor le Terreminator	Троггзор Терранатор
Bling-o-tron 3000	Блескотрон-3000
Hemet Nesingwary	Хеминг Эрнестуэй
Géant mécanique	Заводной великан
Mini stoppe-sort	Контрзаклинательница
Cracheur de suie	Изрыгатель сажи
Garrosh Hurlenfer	Гаррош Адский Крик
Magni Barbe-de-Bronze	Магни Бронзобород
Thrall	Тралл
Morgl l’Oracle	Оракул Моргл
Valeera Sanguinar	Валира Сангвинар
Maiev Chantelombre	Майев Песнь Теней
Uther le Porteur de Lumière	Утер Светоносный
Dame Liadrin	Леди Лиадрин
Prince Arthas	Принц Артас
Rexxar	Рексар
Alleria Coursevent	Аллерия Ветрокрылая
Malfurion Hurlorage	Малфурион
Gul’dan	Гул'дан
Nemsie Nécroflop	Немси Некропшик
Jaina Portvaillant	Джайна Праудмур
Medivh	Медив
Khadgar	Кадгар
Anduin Wrynn	Андуин Ринн
Tyrande Murmevent	Тиранда Шелест Ветра
Flibustière fantôme	Призрачный корсар
Squelettomancien	Скелемант
Déflagroptère boursouflé	Взрывной нетопырь
Pingouin glisseneige	Снежный прыгвин
Vaurien cliquetant	Костяной плут
Nécromancienne sinistre	Мрачный некромант
Drake d’os	Костяной дракон
Val’kyr solnée	Светозарная валь'кира
Plaiedécaille cobalt	Кобальтовый губитель
Hurleur nocturne	Ночной завыватель
Venimancien	Ядомант
Croisé arrogant	Надменный рыцарь
Protectrice vertueuse	Праведная защитница
Sombre conviction	Неправедный суд
Profanation	Осквернение
Tisse-destin	Пряха Судьбы
Flèche toxique	Токсичная стрела
Tisse-toile	Паутина
Druidesse de l’essaim	Друид-роевик
Fais le mort	Ложная смерть
Plaie envahissante	Ползучая чума
Drain d’âme	Похищение души
Cryostase	Криостаз
Brrrloc	Брррлок
Armure piton-de-feu	Пламенеющий доспех
Lame de sang	Кровавый клинок
Baron des os	Повелитель костей
Vrygoule	Врайдалак
Marche-glace	Ледяной ходок
Adjuratrice spectrale	Жуткая кудесница
Deuil de la Lumière	Скорбь Света
Seigneur de l’effroi abject	Гадкий натрезим
Avalanche	Лавина
Grognement	Мертвая хватка
Défenseur drakkari	Защитник драккари
Clone de glace	Ледяные двойники
Apprentie damnée	Обреченная ученица
Fléau ultime	Тотальное заражение
Mystères glacés	Ледяные загадки
Maléficieuse vaudou	Проклинательница
Pêche sur glace	Подледная ловля
Géant fureur-des-neiges	Снежный великан
Main du mort	Рука мертвеца
Vétéran d’Acherus	Ветеран Акеруса
Pêcheur rohart	Клыкарр-рыболов
Clerc du Soleil déchu	Падшая син'дорай
Colosse de la fournaise	Тигельный колосс
Fléau des tombes	Могильный громадень
Rôdeur des tombes	Могильный скрытень
Abomination tic-taquante	Тикающее поганище
Piège frappe-venin	Ядовитая ловушка
Jet d’osselets	Бросок костей
Professeur Putricide	Профессор Мерзоцид
Traîtrise	Вероломство
Dévoration mentale	Пожирание разума
Ascendante de l’ombre	Прислужница Тени
Acolyte de l’agonie	Служитель агонии
Servitude éternelle	Вечное служение
Statue d’obsidienne	Обсидиановая статуя
Archevêque Benedictus	Архиепископ Бенедикт
Démon hurleur	Воющая тварь
Chevalier mortécaille	Рыцарь Мертвожабрых
Poison sangsue	Похищающий жизнь яд
Boomerang damné	Умеранг
Essence d’ombre	Сущность тени
Brise-glace	Ледорез
Berserker animé	Оживленный берсерк
Hanteur de la runeforge	Рунный упырь
Veuve nécrophage	Трупная вдова
Résistance désespérée	До последнего вздоха
Garde noir	Черный страж
Âmefroide	Хладный дух
Résurrecteur	Воскреситель мертвых
Forge des Âmes	Кузня Душ
Moorabi	Мураби
Le roi-liche	Король-лич
Trognepus	Гниломорд
Gnomeferatu	Гномферату
Brigue-âme val’kyr	Похитительница душ
Pisteur recousu	Заштопанный следопыт
Ours-requin	Медвекула
Revenant d’outre-tombe	Загробный гость
Enchaînés de saronite	Дренеи-каторжники
Nécroratrice	Вестница смерти
Laboureur maudit	Проклятый фермер
Sacrifice nécessaire	Невольная жертва
Thrall le mort-voyant	Провидец смерти Тралл
Goule joyeuse	Веселый вурдалак
Geist rôdeur	Крадущийся упырь
Fossoyeuse futile	Гробокопательница
Palefroi d’os	Костяная кобыла
Détrameur nérubien	Нерубский мастер сетей
Commandant hurlant	Воющий командир
Fouet spirituel	Астральная плеть
Pillard dure-écaille	Крепкий мародер
Seigneur des cryptes	Владыка склепа
Scientifique de la peste	Исследователь чумы
Punisseur hachemort	Каратель с топором
Lilian Voss	Лилиан Восс
Chariot à viande	Мясной фургон
Champion frisselame	Рыцарь Ледяного Клинка
Simulacre	Симулякр
Archer abominable	Поганый стрелок
Valeera l’Exsangue	Валира Иссохшая
Rexxar le nécrotraqueur	Ловчий смерти Рексар
Uther de la Lame d’ébène	Утер Черный Клинок
Anduin le faucheur noir	Темный жнец Андуин
Gul’dan le saccage-sang	Кровопийца Гул'дан
Malfurion le Putride	Малфурион Пагубный
Jaina liche de givre	Ледяной лич Джайна
Garrosh seigneur du Fléau	Владыка Плети Гаррош
Hadronox	Хадронокс
Souffle de Sindragosa	Дыхание Синдрагосы
Venez vous battre !	Кто на меня?!
Sindragosa	Синдрагоса
Reine de sang Lana’thel	Королева Лана'тель
Étreinte ténébreuse	Темные объятия
Lame-de-l’ombre	Теневой клинок
Prince Keleseth	Принц Келесет
Prince Taldaram	Принц Талдарам
Prince Valanar	Принц Валанар
Arfus	Псартас
Coursegivre hyldnir	Хильдская всадница
Tisse-sort	Прядильщица чар
Bolvar sang-de-feu	Болвар Опаленный
Geist nécrotique	Некротический упырь
Enchanteresse drakkari	Чародейка драккари
Brise-esprit	Сокрушитель разума
Fêtard sanguin	Кровавый гедонист
Squelette malfaisant	Злобный скелет
Ver de sang	Кровавый червь
Pilleuse spectrale	Вороватый дух
Banshee plaintive	Голосящая банши
Capte-talents	Похитительница трупов
Zélote impure	Нечестивый фанатик
Surprise du chef	Фокус-котус
Gentille grand-mère	Бабушка
Chasseresse capuchonnée	Скрытная охотница
Grimoire bavard	Болтливая книга
Templier Plaie-de-nuit	Страж Ночной Погибели
Comédien pompeux	Напыщенный актер
Purification	Очищение
Méchante sorcière	Злая колдунья
Kara Kazham !	Сим-каражим!
Protégez le roi !	Спасай короля!
Écrase-patate	Несчастье шута
Œuf runique	Руническое яйцо
Araignée du garde-manger	Буфетный паучок
Wyrm de bibliothèque	Книгозмей
Prêtre du festin	Жрец-обжора
Anomalie arcanique	Волшебная аномалия
Gardien aviaire	Пернатый страж
Rôdeur des douves	Канавный скрытень
Moroes	Мороуз
Cavalier en ivoire	Белый конь
Le conservateur	Смотритель
Biographe de Dédain-du-Néant	Историк Гнева Пустоты
Griffes spectrales	Призрачные когти
Gardienne de la Ménagerie	Зверовод
Fieffé forban	Пират-пройдоха
Colporteur éthérien	Эфириал-торговец
Portail du Maelström	Портал: Водоворот
Portail de Reflet-de-Lune	Портал: Лунная поляна
Portail des terres de Feu	Портал: Огненные Просторы
Portail de Lune-d’Argent	Портал: Луносвет
Diablotin de Malchezaar	Бес Малчезара
Portail de Forgefer	Портал: Стальгорн
Valet de Medivh	Лакей Медива
Fourchette mortelle	Острая вилка
Zoobot	Зообот
Prince Malchezaar	Принц Малчезар
Medivh, le Gardien	Хранитель Медив
Barnes	Барнс
Fou en onyx	Черный слон
Golem d’argenterie	Посудный голем
Corbeau enchanté	Колдовской ворон
Magicien de la Ménagerie	Зверомаг
Forge-Arcanes	Волшебный кузнец
Géant arcanique	Волшебный великан
Illusionniste pourpre	Иллюзионистка
Torche oubliée	Забытый факел
Adjurateur éthérien	Кудесник-эфириал
Conservateur du musée	Смотритель музея
Malédiction de Rafaam	Проклятие Рафаама
Destructeur d’obsidienne	Обсидиановый крушитель
Serpent de la fosse	Гадюка
Reno Jackson	Рено Джексон
Pilleur de tombes	Расхититель гробниц
Élémentaire grondant	Гремящий элементаль
Gardienne d’Uldaman	Хранитель Ульдамана
Trogg des tunnels	Туннельный трогг
Raptor déterré	Ископаемый ящер
Dromadaire du désert	Пустынный верблюд
Piège de fléchettes	Ловушка с дротиками
Singe féroce	Яростная макака
Sinistre colporteur	Черный археолог
Tous les murlocs de ta vie	Мурглвратности судьбы
Épreuve sacrée	Священный суд
Scarabée orné de joyaux	Драгоценный скарабей
Sorcière des mers naga	Морская ведьма
Gorillobot A-3	Гориллабот А-3
Crapaud énorme	Огромная жаба
Araignée des tombes	Могильный паук
Raptor de monte	Ездовой ящер
Sélénien de la jungle	Тропический совух
Djinn des zéphirs	Джинн ветров
Sentinelle Anubisath	Анубисат-часовой
Diablosaure fossilisé	Окаменелый дьявозавр
Sir Finley Mrrgglton	Сэр Финли Мрргглтон
Brann Barbe-de-Bronze	Бранн Бронзобород
Élise Cherchétoile	Элиза Звездочет
Pierre d’invocation	Камень призыва
Avortons tremblants	Башня из пигмеев
Prince voleur Rafaam	Великий вор Рафаам
Ensevelir	Погребение
Chapeau d’explorateur	Шляпа исследователя
Statue sinistre	Зловещая статуя
Ombre ancienne	Древняя тень
Mal déterré	Раскопанное зло
Tout est vraiment génial	Все у нас мррглклассно!
Idole corbeau	Статуя ворона
Chercheuse du Reliquaire	Искательница Реликвария
Lame maudite	Проклятый клинок
Armure animée	Оживленные доспехи
Murloc mini-aileron	Малый Плавник
Cri psychique	Ментальный крик
Homoncule sans-gêne	Грубый гомункул
Kobold de bibliothèque	Кобольд-библиотекарь
Sombre pacte	Темный пакт
Saccageur sadique	Крюконосец-разоритель
Marcheuse fal’dorei	Фал'дорайский странник
Trouve-qui-brille	Пещерная блестяшница
Barbare kobold	Кобольд-варвар
Améthyste de sort inférieure	Оберег: малый аметист
Gantelet à lame	Длань-клинок
Écorce	Дубовая кожа
Golem en bois de fer	Голем из древостали
Jaspe de sort inférieur	Оберег: малая яшма
Embranchement	Развилка
Tigre astral	Астральный тигр
Main écrasante	Сокрушающая длань
Ermite kobold	Кобольд-отшельник
Saphir de sort inférieur	Оберег: малый сапфир
Rôdeur des égouts	Обитатель стоков
Frappe latérale	Обходной удар
Hydre des cavernes	Пещерная гидра
Monstre errant	Блуждающий монстр
Émeraude de sort inférieure	Оберег: малый изумруд
Rhok’delar	Рок'делар
Potion d’héroïsme	Зелье героизма
Perle de sort inférieure	Оберег: малая жемчужина
Appel aux armes	К оружию!
Runes explosives	Взрывающиеся руны
Rubis de sort inférieur	Оберег: малый рубин
Parchemin changeant	Свиток-перевертыш
Deck miraculeux	Колода чудес
Aluneth	Алунет
Scorpiomatic	Скорпобот
Élémentaire de cire	Восковой элементаль
Forgeron d’ébène	Дракон-кузнец
Vase corrosive	Едкий слизнюк
Champion solitaire	Герой-одиночка
Basilic peau de pierre	Камнекожий василиск
Tyran des Arcanes	Магический деспот
Gelée verte	Зеленое желе
Tueuse de dragons	Убийца драконов
Coffre carnassier	Зубастый сундук
Diable sournois	Демон-проныра
Dragon assoupi	Спящая драконица
Dragon au trésor	Запасливый дракон
Ver tunnelier	Коридорный ужас
Moussorceleur furbolg	Фурболг-мохомант
Barde inspirée	Громкоголосый бард
Ver géant violet	Лиловый червь
Cavalier Mufle-de-gravier	Камнерыл-рыцарь
Cube carnivore	Плотоядный куб
Sonya Danselombre	Соня Тенепляс
Fongimancien	Грибомант
Familier corbeau	Ворон-фамилиар
Fureur du dragon	Ярость дракона
Avant-garde d’argent	Стражница авангарда
Appel du crépuscule	Зов сумерек
Coursier chatoyant	Мерцающий скакун
Mithril de sort inférieur	Оберег: малый мифрил
Trompe-la-mort	Обман смерти
Âme de dragon	Душа дракона
Trahison soudaine	Внезапное предательство
Ménestrel elfe	Эльф-менестрель
Évasion	Ускользание
Lynessa Tristesoleil	Линесса Печаль Солнца
À mes côtés	Ко мне!
Bafouilleur farouche	Дикий бормотун
Cire-à-l’arc	Свечкострел
Artificier des Arcanes	Магический бронник
Disciple maudit	Проклятый ученик
Taupe sinistre	Жуткий крот
Élixir non identifié	Неопознанный эликсир
Bouclier non identifié	Неопознанный щит
Maillet non identifié	Неопознанный молот
Brasse-champi	Грибовар
Laquais possédé	Одержимый лакей
Appel du chêne	Зов чащобы
Lion de cristal	Хрустальный лев
Gardien griffu	Косолапый страж
Trogg gobe-gloups	Трогг-мрачноед
Seigneur fongique Ixlid	Архигриб Икслид
Gain de niveau !	Новый уровень!
Talismans primordiaux	Талисманы стихий
Apprenti kobold	Кобольд-адепт
Lutin cupide	Жадный дух
Sonde psionique	Псионный зонд
Marin le malandrin	Марин Лис
Gravats le ruine-monde	Грамбл, сотрясатель миров
Geôlier acariâtre	Кобольд-тюремщик
Déluge de coups	Шквал гнева
Golem serti de gemmes	Инкрустированный голем
Armurier sèche-moustache	Сухоус-бронник
Seigneur du Vide	Повелитель Бездны
Regroupement	Всей группой!
Pluie guérisseuse	Целительный ливень
Recruteuse de la guilde	Вербовщица гильдии
Tranche-malheur	Бедоруб
Moine kobold	Кобольд-монах
Ettin affamé	Голодный эттин
Enchanteur mycélien	Гриб-чародел
Kobold farfouilleur	Кобольд-барахольщик
Brindille de l’Arbre-Monde	Ветвь Древа Жизни
Chantepignon	Визжащий гриб
Djinn bienveillant	Великодушный джинн
Brise-pénombre	Вестник заката
Illusionniste kobold	Кобольд-иллюзионист
Scarabée cuirassé	Бронированный жук
Grand archiviste	Великий архивариус
Rin la première disciple	Первоученица Рин
Cataclysme	Катаклизм
Crâne du Man’ari	Череп Ман'ари
Val’anyr	Вал'анир
Onyx de sort inférieur	Оберег: малый оникс
Évolution instable	Изменчивая эволюция
La Sorcelance	Рунное копье
Diamant de sort inférieur	Оберег: малый алмаз
Kathrena Fétu-d’Hiver	Катрена Зимний Шорох
Zola la gorgone	Зола Горгона
Élémentaire murmurant	Рокочущий элементаль
Mande-foudre des Vents	Ветрорез-призыватель
Géosculpteur Yip	Геоскульптор Йип
Suinteux suintant	Журчащий слизнюченыш
Maître Chênecœur	Мастер Сердцедуб
Murs broyeurs	Сокрушающие стены
Les ténèbres	Тьма
Acolyte du Crépuscule	Сумеречный послушник
Déchireur du Vide	Потрошитель Бездны
Gargouille dorée	Золоченая горгулья
Mande-dragon Alanna	Дракономант Аланна
Manipulateur tellurique	Элементаль-манипулятор
Temporus	Темпорус
Invocatrice malveillante	Злая призывательница
Couve-dragon	Драконозаводчик
Roi Cire-Pilleur	Король Вихлепых
Plaie des rois	Погибель королей
Pacte sacrificiel	Жертвенный договор
Disparition	Исчезновение
Kidnappeur	Похититель
Météores	Звездопад
Ancien du savoir	Древо мудрости
Al’Akir, seigneur des Vents	Ал'акир
Soldat d’élite kor’kron	Кор'кронский воин
Wyrm de mana	Маназмей
Maîtresse du déguisement	Мастер маскировки
Perroquet du capitaine	Попугай капитана
Crabe affamé	Голодный краб
Mousse de la Voile sanglante	Дерзкая налетчица
Jongleur de couteaux	Жонглер кинжалами
Pyromancien sauvage	Яростный пиромант
Auspice funeste	Вестник рока
Corsaire de l’effroi	Жуткий корсар
Dragon féerique	Чудесный дракончик
Capitaine Vertepeau	Капитан Зеленямс
Forban de la Voile sanglante	Кровожадный корсар
Enseignante pourpre	Учительница магии
Capitaine des mers du Sud	Капитан Южных морей
Millhouse Tempête-de-Mana	Миллхаус Манашторм
Aile de mort	Смертокрыл
Compagnon animal	Питомец
Cri de commandement	Командирский крик
Maître fabricant d’épées	Мастер ковки клинков
Gruul	Груул
Lardeur	Дробитель
Kodo déchaîné	Несущийся кодо
Inquisiteur Aileron noir	Мурквизитор
Fusion primordiale	Сила стихий
Sans-visage nimbé de flammes	Пламенный безликий
Sentinelle éternelle	Вечный страж
Évolution	Эволюция
Chose venue d’en bas	Нечто из глубин
Marteau du crépuscule	Молот Сумерек
Tentacules brachiaux	Цепкие щупальца
Grouillant silithide	Силитид-членистоног
Y’Shaarj, la rage déchaînée	И'Шарадж
Fandral Forteramure	Фэндрал Олений Шлем
Infester	Заражение
Rage farouche	Звериное неистовство
Marque d’Y’Shaarj	Метка И'Шараджа
Ancien frappé d’interdit	Запретное древо
En chasse	Охота
Sectateur de la Lame	Сектант-убийца
Périple dans les abîmes	Путь через глубины
Thé de chardon	Скорополоховый чай
Xaril l’Esprit empoisonné	Ксарил
Fracasser	Раскол
Kobold évolué	Мутировавший кобольд
Mande-flamme du Crépuscule	Сумеречный пиромант
Mande-givre dément	Безумный служитель льда
Flamme interdite	Запретное пламя
Serviteur de Yogg-Saron	Слуга Йогг-Сарона
Grimoire de cabaliste	Фолиант заговорщика
Mot de pouvoir : Tentacules	Слово силы: Щупальца
Soigneuse du Crépuscule	Сумеречная целительница
Mot de l’ombre : Horreur	Слово Тьмы: Ужас
Mutation interdite	Запретная форма
Sombre orateur	Темный проповедник
Étreindre l’ombre	Объятия Тьмы
Archiviste de Sombre-Comté	Библиотекарь Темнолесья
Conseiller de Sombre-Comté	Член совета Темнолесья
Rituel interdit	Запретный ритуал
Folie galopante	Заразительное безумие
Parjurer les ténèbres	Отречение от Тьмы
Anomalus	Аномалус
Cho’gall	Чо'Галл
Mukla, tyran du val	Мукла, Гроза Долины
Déphaseur Zerus	Оборотень Зерус
Empereur jumeau Vek’lor	Император Век'лор
N’Zoth le corrupteur	Н'Зот
Yogg-Saron, la fin de l’espoir	Йогг-Сарон
Prophète nérubien	Нерубский пророк
Béhémoth sans-visage	Безликий гигант
Horreur indicible	Зловещий ужас
Psych-o-tron	Психонатор
Robot de soins corrompu	Оскверненный исцелятор
Goule ravageuse	Буйный вурдалак
Berserker aberrant	Искаженный берсерк
Tentacule de N’Zoth	Щупальце Н'Зота
Faucon-dragon difforme	Уродливый дракондор
Rampant des marais	Болотный ползун
Murloc aileron-bilieux	Порочный волнолов
Initié zélé	Ревностный аколит
Voyant corrompu	Падший провидец
Disciple de C’Thun	Поборник К'Туна
Sang de l’Ancien	Кровь Древнего
Traînard sans-visage	Безликий шаркун
Attaque d’ombre	Теневой удар
Chauve-souris embrasée	Огненный нетопырь
Tisse-ambre klaxxi	Прядильщик клакси
Feux follets funestes	Древние огоньки
Guérison interdite	Запретное исцеление
Auspice funeste confirmé	Вестник доказанного рока
Gardien du bourbier	Хранитель болот
Coup de tonnerre	Удар молнии
Invocateur sans-visage	Безликий призыватель
Hallazèle l’Élevé	Халлазил Перерожденный
Appel de la nature	Зов лесов
Loup contaminé	Зараженный волк
Brave Sabot-de-Sang	Храбрец Кровавого Копыта
Malkorok	Малкорок
Héroïne altruiste	Самоотверженная героиня
Lame de ralliement	Объединяющий клинок
Force divine	Божественная сила
Ragnaros, porteur de Lumière	Рагнарос Слуга Света
Alchimiste de Sombre-Comté	Алхимик Темнолесья
MALÉDICTION !	Погибель!
Villageois possédé	Одержимый крестьянин
Worgen corrompu	Искаженный ворген
Enragé am’gam	Яростень Ам'гам
Tauren contaminé	Зараженный таурен
Mange-secrets	Пожиратель секретов
Implorateur funeste	Призыватель Рока
Rejeton de N’Zoth	Порождение Н'Зота
Face de poulpe	Кальмарный пират
Cauchemar écailleux	Чешуйчатый кошмар
Invocateur du Crépuscule	Сумеречный призыватель
Résister aux ténèbres	Преграда на пути Тьмы
Guerriers de sang	Кровавые воины
C’Thun	К'Тун
Annonciatrice du mal	Зовущая Зло
Lame de C’Thun	Клинок К'Туна
Élue de C’Thun	Избранница К'Туна
Géomancienne du Crépuscule	Сумеречный геомант
Ancien du Crépuscule	Сумеречный предок
Ancien héraut	Древняя предвестница
Exhalombre	Темная чародейка
Traqueur lugubre	Одинокий охотник
Sombre arakkoa	Темный араккоа
Apothicaire du culte	Аптекарь-сектант
L’Épouvantueur	Букамонстр
Ancienne porte-bouclier	Древний щитоносец
Passeuse d’âmes	Привратница душ
Ensorceleuse du culte	Колдунья-сектантка
Ver des sables géant	Огромный песчаный червь
Princesse Huhuran	Принцесса Хухуран
Régisseuse de Sombre-Comté	Распорядитель Темнолесья
Lumière dans les ténèbres	Свет во Тьме
Second de N’Zoth	Первый помощник Н'Зота
Grizzly perturbé	Обезумевший гризли
Du sang à l’ichor	Кровь и гной
Adepte de la Voile sanglante	Пират-сектантка
Héraut Volazj	Глашатай Волаж
Seigneur Aile de mort	Владыка Смертокрыл
Lardeur, Perte d’Elwynn	Кошмарный Дробитель
Drake de minuit	Полночный дракон
Adorateur fanatisé	Безумный служитель
Pirate des flots noirs	Пират Черноводья
Amasseur vicié	Грязный барахольщик
Larve putride	Личинка-падальщик
Sanglier de pénombre	Темный вепрь
Tentacule remuant	Извивающееся щупальце
Maître de l’évolution	Мастер эволюции
Colporteur de Fossoyeuse	Торговец из Подгорода
Acolyte capuchonnée	Скрытная послушница
Ombre mouvante	Изменчивая тень
Horreur cyclopéenne	Одноглазый ужас
Nat le sombre pêcheur	Нат, Темный Рыболов
Sectateur Skeram	Сектант Скерама
Soggoth le Rampant	Соггот
Elite Tauren Chieftain	E.T.C.
Goule mangeuse de chair	Плотоядный вурдалак
Courbe-sort	Чароплет
Jeune pterreurdactyle	Птенец терродактиля
Volcanosaure	Вулканозавр
Gigantosaure	Динозаврение
Ravasaure chétif	Малыш-равазавр
Battrodon rassasié	Сытый жесткозуб
Hydrologue	Гидролог
Garde-soleil Tarim	Хранитель Солнца Тарим
Geyser de flammes	Огненный гейзер
Élémentaire d’air	Элементаль воздуха
Arcanologue	Арканолог
Surgisseur de vapeur	Паровая туча
Mande-mirage	Призыватель миражей
Liens de mana	Узы маны
Volcan	Вулкан
Pyros	Пирос
Ouverture du portail	Связующая спираль
Visions de l’Ombre	Темные видения
Soins de lien	Связующее исцеление
Oracle cristallin	Кристаллический оракул
Élémentaire radieux	Сияющий элементаль
Racinéclat curieux	Чудной сверкорень
Lève-carapace tortollan	Тортолльская стражница
Pterreurdactyle vorace	Ненасытный терродактиль
Rôdeur du goudron	Смоляной скрытень
Salve de tranche-pétales	Шквал остроцветов
Flagellant tranche-pétale	Колкий остроцвет
Cosse caméléon	Мимикрия
Éclat d’obsidienne	Обсидиановый осколок
Herbosaurus	Кусачник
Vilépine tueuse	Кровожадный злолист
Shérazine, fleur putrescente	Шеразин
Grotte des profondeurs	Подземные пещеры
Sculpte-pierre tol’vir	Тол'вирский камнемаг
Mastodonte géant	Огромный мастодонт
Défenseur de Butte-Pierre	Защитник холмов
Chasseur rochecave	Озерный охотник
Pterreurdactyle vicieux	Коварный птенец
Œuf-nappeur	Яйцекрад
Fourrageur tortollan	Тортолльская сборщица
Écraseur gelé	Ледяной сокрушитель
Lézard-tonnerre	Рокочущий ящер
Œuf de diablosaure	Яйцо дьявозавра
Phénix de la Fournaise	Феникс Огненного Венца
Reine émeraude	Изумрудная королева
Anaconda géant	Огромная анаконда
Hydre flot-amer	Гидра Горьких Волн
Primaliste tortollan	Тортолльская шаманка
Gentil mégasaure	Кроткий мегазавр
Diablosaure chargé	Заряженный дьявозавр
Brachiosaure verdoyant	Зеленое длинношеее
Change-carapace	Перевертыш
Spores évolutives	Споры роста
Écailles terrestres	Земляная чешуя
Ancien brachiosaure	Древнее длинношеее
Mana vivant	Живая мана
Éclaireur enthousiaste	Зоркая разведчица
Géants de la jungle	Исполины джунглей
Totem primaileron	Тотем палеомурлоков
Messager de la Fournaise	Вестник Огненного Венца
Éclat glaciaire	Ледниковый осколок
Sentinelle de pierre	Каменный часовой
Seigneur Kalimos	Калимос Первородный
Traqueur écaille-de-terreur	Ловчий злобноплав
Roc nicheur	Рух-наседка
Saccageur émeraude	Изумрудный разоритель
Ultrasaure	Ультразавр
Clampant de Golakka	Ползун Голакка
Gastéropode têtu	Упрямый брюхоног
Flammetin	Огневичок
Stégosaure	Стегодон
Traqueur dent de sabre	Хищный саблезуб
Guette-tempête	Страж бурь
Guêpe géante	Гигантская оса
Serviteur de Kalimos	Слуга Калимоса
Vague de marée	Гнев прилива
Élémentaire volatil	Нестабильный элементаль
Arme toxique	Отравленное оружие
Sacrifice lakkari	Жертва Лаккари
Dinomancien cruel	Жестокий диномант
Brume corruptrice	Пелена порчи
Fleur de sang	Кроволист
Gangrechien lakkari	Гончая Лаккари
L’heure du repas	Налетай!
Tunnelier cliquetant	Стрекочущий землерой
Matriarche Zavas	Королева Завас
Seigneur du goudron	Смоляной дух
Hemet de la jungle	Охотник Хеминг
Le Voraxx	Воракс
Tranchefeuille monstrueux	Исполинский бритволист
Élémentaire igné	Пылкий элементаль
Tempête chatoyante	Проблеск бури
Mande-brasier	Вестник зарева
Drake primordial	Доисторический дракон
Élise la Pionnière	Первопроходец Элиза
Tyrantus	Тирантий
Libéré de l’ambre	Нечто из янтаря
Hallucination	Иллюзия
Chante-esprit Umbra	Волхвица Умбра
Ozruk	Озрук
Grave morsure	Болезненный укус
Ara orné de joyaux	Самоцветный ара
Gardien tol’vir	Тол'вирский часовой
Jeune raptor	Детеныш ящера
Tranchegueule crépitant	Искрящий острозуб
Ruée	Дикий гон
Dinomancie	Диномантия
Roi du marais Dred	Король болот Дред
La reine du marécage	Королева болот
Exploration d’Un’Goro	Изучение Ун'Горо
Peau de fer	Железная шкура
Navrecorne hargneux	Злой дикорог
Factionnaire acculée	Разведчица в беде
Genèse soudaine	Внезапногенез
Rampeur du goudron	Смоляной страж
Lame magmatique	Клинок из лавы
Roi Mosh	Король Мош
Cœur de la Fournaise	Сердце Огненного Венца
Guetteur primaileron	Палеомурлок-разведчик
Gardien des sources	Страж гейзера
Réveil des Faiseurs	Пробуждение творцов
Glyphe primordial	Петроглиф
Les murlocs font la force	Мурлочий союз
Limon glouton	Прожорливая слизь
Reflet de magma	Копия из лавы
Tranche-lianes	Лозоруб
Destrier à pointes	Гребнистый скакун
Champion primaileron	Палеомурлок-защитник
Le dernier kaléïdosaure	Последний калейдозавр
Météore	Метеорит
Écho spirituel	Отголоски духов
Jeune navrecorne	Детеныш дикорога
Perdus dans la jungle	Заблудившиеся в джунглях
Adaptabilité	Адаптация
Stégosaure magmafeu	Сияющий стегодон
Lyra, l’éclat du soleil	Лира Осколок Солнца
