Flammenlanze	Flame Lance
Effigie	Effigy
Gefallener Held	Fallen Hero
Arkanschlag	Arcane Blast
Verwandlung: Eber	Polymorph: Boar
Streiter von Dalaran	Dalaran Aspirant
Zauberkünstler	Spellslinger
Drache von Kaltarra	Coldarra Drake
Rhonin	Rhonin
Wilder Widderbändiger	Ram Wrangler
Heiliger Champion	Holy Champion
Ausgeburt der Schatten	Spawn of Shadows
Machtwort: Ruhm	Power Word: Glory
Schattengeist	Shadowfiend
Bekehren	Convert
Verwirren	Confuse
Zwielichtwächter	Twilight Guardian
Beichtpatin Blondlocke	Confessor Paletress
Schreckensross	Dreadsteed
Fiese Verdammniswache	Fearsome Doomguard
Miniritter des Bösen	Tiny Knight of Evil
Jaraxxus' Faust	Fist of Jaraxxus
Leervernichter	Void Crusher
Dämonische Fusion	Demonfuse
Finsterer Handel	Dark Bargain
Zornwächter	Wrathguard
Wilfred Zischknall	Wilfred Fizzlebang
Shado-Pan-Reiter	Shado-Pan Rider
Bukanier	Buccaneer
Recke von Unterstadt	Undercity Valiant
Taschendieb	Cutpurse
Zwielichtiger Händler	Shady Dealer
Lange Finger	Burgle
Vergiftete Klinge	Poisoned Blade
Unter dem Kolosseum	Beneath the Grounds
Anub'arak	Anub'arak
Lebendige Wurzeln	Living Roots
Streiterin von Darnassus	Darnassus Aspirant
Wilder Kämpfer	Savage Combatant
Wildläuferin	Wildwalker
Ritter der Wildnis	Knight of the Wild
Druidin des Säbelzahns	Druid of the Saber
Astrale Vereinigung	Astral Communion
Kompostieren	Mulch
Aviana	Aviana
Totemiker der Tuskarr	Tuskarr Totemic
Draenei-Totemschnitzerin	Draenei Totemcarver
Welle der Heilung	Healing Wave
Recke von Donnerfels	Thunder Bluff Valiant
Aufgeladener Hammer	Charged Hammer
Elementare Zerstörung	Elemental Destruction
Totemgolem	Totem Golem
Wissen der Ahnen	Ancestral Knowledge
Der Nebelrufer	The Mistcaller
Blitzheilung	Flash Heal
Überspannen	Powershot
Stallmeisterin	Stablemaster
Elekk des Königs	King's Elekk
Schützin des Hochlands	Brave Archer
Bärenfalle	Bear Trap
Geladen und entsichert	Lock and Load
Spinnennest	Ball of Spiders
Ätzschlund	Acidmaw
Schreckensmaul	Dreadscale
Schwungvoller Hieb	Bash
Königsverteidiger	King's Defender
Streiter von Orgrimmar	Orgrimmar Aspirant
Magnataurenalpha	Magnataur Alpha
Stärken	Bolster
Sparringspartner	Sparring Partner
Himmelskäpt'n Kragg	Skycap'n Kragg
Alexstraszas Champion	Alexstrasza's Champion
Varian Wrynn	Varian Wrynn
Wetteifer	Competitive Spirit
Siegel des Champions	Seal of Champions
Schlachtrossausbilder	Warhorse Trainer
Murlocritter	Murloc Knight
Argentumlanze	Argent Lance
Betretet das Kolosseum	Enter the Coliseum
Mysteriöser Ritter	Mysterious Challenger
Garnisonskommandant	Garrison Commander
Eadric der Reine	Eadric the Pure
Einfacher Knappe	Lowly Squire
Drachenfalkenreiter	Dragonhawk Rider
Lanzenträger	Lance Carrier
Maid des Sees	Maiden of the Lake
Saboteur	Saboteur
Argentumreiter	Argent Horserider
Mogors Champion	Mogor's Champion
Knochenwachenleutnant	Boneguard Lieutenant
Muklas Champion	Mukla's Champion
Turniersanitäter	Tournament Medic
Eiswüter	Ice Rager
Frierender Schneebold	Frigid Snobold
Flammenjongleur	Flame Juggler
Schweigsamer Ritter	Silent Knight
Aufziehritter	Clockwork Knight
Turnierzuschauer	Tournament Attendee
Zauberschluckerin	Sideshow Spelleater
Kodoreiterin	Kodorider
Silberne Regentin	Silver Hand Regent
Grubenkämpferin	Pit Fighter
Gefangener Jormungar	Captured Jormungar
Nordmeerkrake	North Sea Kraken
Tuskarrtjoster	Tuskarr Jouster
Verletzter Kvaldir	Injured Kvaldir
Champion des Lichts	Light's Champion
Gepanzertes Schlachtross	Armored Warhorse
Argentumwachmann	Argent Watchman
Meister des Kolosseums	Coliseum Manager
Imbissbuden-Tuskarr	Refreshment Vendor
Tjostmeister	Master Jouster
Anwerber	Recruiter
Arglistiger Querulant	Evil Heckler
Fechtlehrer	Fencing Coach
Wyrmruhagent	Wyrmrest Agent
Zeremonienmeisterin	Master of Ceremonies
Oberste Kreuzfahrerin	Grand Crusader
Räuber der Kvaldir	Kvaldir Raider
Frostriese	Frost Giant
Publikumsliebling	Crowd Favorite
Gormok der Pfähler	Gormok the Impaler
Frostschlund	Chillmaw
Bolf Rammschild	Bolf Ramshield
Eisheuler	Icehowl
Nexus-Champion Saraad	Nexus-Champion Saraad
Der Skelettritter	The Skeleton Knight
Fjola Lichtbann	Fjola Lightbane
Meeresplünderer	Sea Reaver
Eydis Nachtbann	Eydis Darkbane
Justiziarin Treuherz	Justicar Trueheart
Tjosterin von Gadgetzan	Gadgetzan Jouster
Andächtige Totenwache	Solemn Vigil
Flammenschürer	Flamewaker
Drachenodem	Dragon's Breath
Zwielichtwelpling	Twilight Whelp
Dämonenzorn	Demonwrath
Boss der Wichtelgang	Imp Gang Boss
Dreierbande	Gang Up
Dunkeleisenlauerer	Dark Iron Skulker
Vulkanborke	Volcanic Lumberer
Druidin der Flamme	Druid of the Flame
Lavaschock	Lava Shock
Brandwachenzerstörer	Fireguard Destroyer
Schneller Schuss	Quick Shot
Kernwüterich	Core Rager
Rache	Revenge
Axtwerfer	Axe Flinger
Auferstehung	Resurrect
Drachengefährte	Dragon Consort
Grimmiger Gast	Grim Patron
Drachkinzauberer	Dragonkin Sorcerer
Drachenei	Dragon Egg
Drakonidenzermalmer	Drakonid Crusher
Vulkandrache	Volcanic Drake
Hungriger Drache	Hungry Dragon
Majordomus Exekutus	Majordomo Executus
Imperator Thaurissan	Emperor Thaurissan
Rend Schwarzfaust	Rend Blackhand
Nefarian	Nefarian
Chromaggus	Chromaggus
Pechschwingentechnikerin	Blackwing Technician
Pechschwingenverderber	Blackwing Corruptor
Raza der Gefesselte	Raza the Chained
Frosttrank	Freezing Potion
Aufziehbandit	Wind-up Burglebot
Geheimversteck	Hidden Cache
Trickbetrüger	Street Trickster
Roter Manawyrm	Red Mana Wyrm
Jinyuwassersprecher	Jinyu Waterspeaker
Kiezbeschützer	Grimestreet Protector
Durchgeknallter Chemiker	Kooky Chemist
Waltranbaron	Blubber Baron
Vulkanischer Trank	Volcanic Potion
Lakai der Kabale	Kabal Lackey
Ho-zen-Heiler	Hozen Healer
Teufelsfeuertrank	Felfire Potion
Wühlerwiesel	Weasel Tunneler
Meisterin der Mixturen	Mistress of Mixtures
Pflichtverteidiger	Public Defender
Schmuggeltour	Smuggler's Run
Kun der Vergessene König	Kun the Forgotten King
Die Aufräumrgler	Call in the Finishers
Jadehäuptling	Jade Chieftain
Zapp­za­rapp	Finders Keepers
Hinterhofstreuner	Alleycat
Rattenmeute	Rat Pack
Kiezinformant	Grimestreet Informant
Weißauge	White Eyes
Kleinbukanier	Small-Time Buccaneer
Kampfveranstalterin	Fight Promoter
Dr. Faust	Knuckles
Schmuggelware	Smuggler's Crate
Einsatzkodo	Dispatch Kodo
Schießwütiger Strolch	Shaky Zipgunner
Piranhawerfer	Piranha Launcher
Troggdompteur	Trogg Beastrager
Wachtmeisterin Sally	Sergeant Sally
Grummelbukanier	Luckydo Buccaneer
Jadebehemoth	Jade Behemoth
Finja die Todesflosse	Finja, the Flying Star
Jadeidol	Jade Idol
Trank des Wahnsinns	Potion of Madness
Großer Heiltrank	Greater Healing Potion
Drakonidenagent	Drakonid Operative
Manageode	Mana Geode
Kristalltilgtrank	Blastcrystal Potion
Peiniger der Höllenorcs	Fel Orc Soulfiend
Kristallwirker	Crystalweaver
Blutzorntrank	Bloodfury Potion
Zeichen des Lotus	Mark of the Lotus
Kristallklau	Pilfered Power
Träumerin der Erhabenen	Celestial Dreamer
Chemikerin der Kabale	Kabal Chemist
Verwandlungstrank	Potion of Polymorph
Kazakus	Kazakus
Große arkane Geschosse	Greater Arcane Missiles
Kabalenkrallenpriester	Kabal Talonpriest
Gefälschte Münze	Counterfeit Coin
Messingschlagring	Brass Knuckles
Lotusassassine	Lotus Assassin
Schattenwüter	Shadow Rager
Käpt'n Glubschauge	Patches the Pirate
Kiezeintreiber	Grimestreet Enforcer
Hobart Wurfhammer	Hobart Grapplehammer
Dubioser Lepragnom	Backstreet Leper
Pfeilgiftmurloc	Blowgill Sniper
Großstadtgangster	Big-Time Racketeer
Kurierin der Kabale	Kabal Courier
Grimmschuppenkomplize	Grimscale Chum
Nagakorsarin	Naga Corsair
Zweitklassiger Schläger	Second-Rate Bruiser
Ein-Orc-Armee	Hired Gun
Netter Kneipenwirt	Friendly Bartender
Toxischer Klärschlamm	Toxic Sewer Ooze
Gewiefter Detektiv	Streetwise Investigator
Stimmräuber der Kabale	Kabal Songstealer
Taffer Türsteher	Backroom Bouncer
Gadgetzaner Sternchen	Gadgetzan Socialite
Manische Seelenwirkerin	Manic Soulcaster
Schrumpftrank	Pint-Size Potion
Drachenfeuertrank	Dragonfire Potion
Schieberin der Kabale	Kabal Trafficker
Worgenhalbstarker	Worgen Greaser
Knatz-Fu-Meister	Grook Fu Master
Bombenlegerin	Bomb Squad
Doppelgangster	Doppelgangster
Glitzerstibitzer	Burgly Bully
Bürgermeister Noggenfogger	Mayor Noggenfogger
Kryomantin	Cryomancer
Madame Goya	Madam Goya
Don Han'Cho	Don Han'Cho
Tintenmeisterin Solia	Inkmaster Solia
Pickelhaubenheizer	Spiked Hogrider
Jadeshuriken	Jade Shuriken
Jadeschwärmer	Jade Swarmer
Fährfrau von Gadgetzan	Gadgetzan Ferryman
Schattensensei	Shadow Sensei
Devolution	Devolve
Lotusillusionistin	Lotus Illusionist
Seeteufelstecher	Seadevil Stinger
Jadeblitz	Jade Lightning
Jadeblüte	Jade Blossom
Jadegeist	Jade Spirit
Bei den Fischen schlafen	Sleep with the Fishes
Jadeklauen	Jade Claws
Krul der Entfesselte	Krul the Unshackled
Abyssalvollstrecker	Abyssal Enforcer
Diebesgut	Stolen Goods
Kiezausstatter	Grimestreet Outfitter
Schmieriger Tüftler	Grimy Gadgeteer
Kiezpfandleiherin	Grimestreet Pawnbroker
Hinterhofschmiedin	Alley Armorsmith
Korrupter Sheriff	Meanstreet Marshal
Kabalekristallkurierin	Kabal Crystal Runner
Shaku der Sammler	Shaku, the Collector
Dreckige Ratte	Dirty Rat
Fluchtkodo	Getaway Kodo
Furorion	Wrathion
Auktionsmeister Barto	Auctionmaster Beardo
Genzo der Hai	Genzo, the Shark
Tanaris-Borstenheizer	Tanaris Hogchopper
Boss der Borstenheizer	Leatherclad Hogleader
Lunare Visionen	Lunar Visions
Brandbart Loderlunte	Wickerflame Burnbristle
Shed-Ling-Sensei	Virmen Sensei
Rasende Reporterin	Daring Reporter
Lotusagenten	Lotus Agents
Kiezschmugglerin	Grimestreet Smuggler
Urtum der Blüten	Ancient of Blossoms
Meuchler der Defias	Defias Cleaner
Schwarzapotheker	Unlicensed Apothecary
Aya Schwarzpfote	Aya Blackpaw
Frischgebackene Rekruten	Small-Time Recruits
Ich kenn da jemanden ...	I Know a Guy
Fußsoldat von Goldhain	Goldshire Footman
Moorkrabbler	Fen Creeper
Heilige Nova	Holy Nova
Gedankenkontrolle	Mind Control
Inneres Feuer	Inner Fire
Heilige Pein	Holy Smite
Gedankensicht	Mind Vision
Machtwort: Schild	Power Word: Shield
Klaue	Claw
Heilende Berührung	Healing Touch
Mondfeuer	Moonfire
Mal der Wildnis	Mark of the Wild
Wildes Brüllen	Savage Roar
Prankenhieb	Swipe
Wildwuchs	Wild Growth
Verwandlung	Polymorph
Arkane Intelligenz	Arcane Intellect
Frostblitz	Frostbolt
Arkane Explosion	Arcane Explosion
Frostnova	Frost Nova
Spiegelbild	Mirror Image
Blizzard	Blizzard
Feuerball	Fireball
Eislanze	Ice Lance
Flammenstoß	Flamestrike
Wasserelementar	Water Elemental
Frostschock	Frost Shock
Geist der Ahnen	Ancestral Spirit
Windzorn	Windfury
Heilung der Ahnen	Ancestral Healing
Feuerelementar	Fire Elemental
Waffe des Felsbeißers	Rockbiter Weapon
Kampfrausch	Bloodlust
Fernsicht	Far Sight
Schattenblitz	Shadow Bolt
Blutwichtel	Blood Imp
Blutsauger	Drain Life
Höllenfeuer	Hellfire
Verderbnis	Corruption
Schreckenshöllenbestie	Dread Infernal
Leerwandler	Voidwalker
Meucheln	Backstab
Kaltblütigkeit	Cold Blood
Tödliches Gift	Deadly Poison
Finsterer Stoß	Sinister Strike
Attentat	Assassinate
Sprinten	Sprint
Klinge des Assassinen	Assassin's Blade
Mal des Jägers	Hunter's Mark
Segen der Macht	Blessing of Might
Wächter der Könige	Guardian of Kings
Heiliges Licht	Holy Light
Gerechtigkeit des Lichts	Light's Justice
Segen der Könige	Blessing of Kings
Weihe	Consecration
Hammer des Zorns	Hammer of Wrath
Echtsilberchampion	Truesilver Champion
Sturmangriff	Charge
Toben	Rampage
Heldenhafter Stoß	Heroic Strike
Feurige Kriegsaxt	Fiery War Axe
Hinrichten	Execute
Arkanitschnitter	Arcanite Reaper
Spalten	Cleave
Seher des Irdenen Rings	Earthen Ring Farseer
Magmawüter	Magma Rager
Oasenschnappkiefer	Oasis Snapjaw
Flusskrokilisk	River Crocolisk
Frostwolfgrunzer	Frostwolf Grunt
Schlachtzugsleiter	Raid Leader
Wolfsreiter	Wolfrider
Eisenpelzgrizzly	Ironfur Grizzly
Silberrückenpatriarch	Silverback Patriarch
Ritter von Sturmwind	Stormwind Knight
Schütze von Eisenschmiede	Ironforge Rifleman
Koboldgeomant	Kobold Geomancer
Südmeerdeckmatrose	Southsea Deckhand
Gnomische Erfinderin	Gnomish Inventor
Sturmlanzenkommando	Stormpike Commando
Ritter der Silbernen Hand	Silver Hand Knight
Erzmagier	Archmage
Rabenholdtassassine	Ravenholdt Assassin
Herr der Arena	Lord of the Arena
Murlocräuber	Murloc Raider
Junger Drachenfalke	Young Dragonhawk
Steinhauereber	Stonetusk Boar
Blutsumpfraptor	Bloodfen Raptor
Blaukiemenkrieger	Bluegill Warrior
Schildmeista von Sen'jin	Sen'jin Shieldmasta
Verletzter Klingenmeister	Injured Blademaster
Eiswindyeti	Chillwind Yeti
Kriegsgolem	War Golem
Goblinleibwächter	Booty Bay Bodyguard
Ruchloser Unteroffizier	Abusive Sergeant
Elfenbogenschützin	Elven Archer
Jägerin der Klingenhauer	Razorfen Hunter
Ogermagier	Ogre Magi
Oger der Felsfäuste	Boulderfist Ogre
Kernhund	Core Hound
Eisenschnabeleule	Ironbeak Owl
Irre Raketenschützin	Reckless Rocketeer
Hasserfüllte Schmiedin	Spiteful Smith
Champion von Sturmwind	Stormwind Champion
Frostwolfkriegsfürst	Frostwolf Warlord
Söldner der Venture Co.	Venture Co. Mercenary
Irrwisch	Wisp
Eisenborkenbeschützer	Ironbark Protector
Klingenwirbel	Blade Flurry
Schattenwort: Schmerz	Shadow Word: Pain
Klerikerin von Nordhain	Northshire Cleric
Göttlicher Wille	Divine Spirit
Verhungernder Bussard	Starving Buzzard
Dunkelschuppenheilerin	Darkscale Healer
Hundemeister	Houndmaster
Waldwolf	Timber Wolf
Tundranashorn	Tundra Rhino
Mehrfachschuss	Multi-Shot
Fährtenlesen	Tracking
Arkaner Schuss	Arcane Shot
Langbogen des Gladiators	Gladiator's Longbow
Gedankenschlag	Mind Blast
Lichtwächterin	Lightwarden
Der Schwarze Ritter	The Black Knight
Junge Priesterin	Young Priestess
Großwildjäger	Big Game Hunter
Alarm-o-Bot	Alarm-o-Bot
Akolyth des Schmerzes	Acolyte of Pain
Argentumknappin	Argent Squire
Wütendes Huhn	Angry Chicken
Worgenspitzel	Worgen Infiltrator
Voodoodoktor	Voodoo Doctor
Blutmagier Thalnos	Bloodmage Thalnos
König Mukla	King Mukla
Ingenieurslehrling	Novice Engineer
Sylvanas Windläufer	Sylvanas Windrunner
Dschungelpanther	Jungle Panther
Blutelfenklerikerin	Shattered Sun Cleric
Scharlachrote Fanatikerin	Scarlet Crusader
Scharfseher von Thrallmar	Thrallmar Farseer
Wache von Silbermond	Silvermoon Guardian
Drachlingmechanikerin	Dragonling Mechanic
Schlingendorntiger	Stranglethorn Tiger
Lepragnom	Leper Gnome
Sonnenläuferin	Sunwalker
Windzornharpie	Windfury Harpy
Zwielichtdrache	Twilight Drake
Rastloser Abenteurer	Questing Adventurer
Uralter Wächter	Ancient Watcher
Dunkeleisenzwerg	Dark Iron Dwarf
Zauberbrecher	Spellbreaker
Junger Braumeister	Youthful Brewmaster
Tiefenlichtorakel	Coldlight Oracle
Manasüchtige	Mana Addict
Uralter Braumeister	Ancient Brewmaster
Sonnenzornbeschützerin	Sunfury Protector
Verrückter Alchemist	Crazed Alchemist
Trübauge der Alte	Old Murk-Eye
Säurehaltiger Schlamm	Acidic Swamp Ooze
Argentumkommandant	Argent Commander
Winzige Beschwörerin	Pint-Sized Summoner
Geheimnisbewahrerin	Secretkeeper
Verrückter Bomber	Mad Bomber
Tüftlermeister Oberfunks	Tinkmaster Overspark
Kriegshymnenanführerin	Warsong Commander
Gedankenkontrolleur	Mind Control Tech
Arkangolem	Arcane Golem
Kabaleschattenpriesterin	Cabal Shadow Priest
Verteidiger von Argus	Defender of Argus
Goblinauktionator	Gadgetzan Auctioneer
Beutehamsterer	Loot Hoarder
Monstrosität	Abomination
Lehrensucher Cho	Lorewalker Cho
Verwüster	Demolisher
Tiefenlichtseher	Coldlight Seer
Bergriese	Mountain Giant
Cairne Bluthuf	Cairne Bloodhoof
Gelbin Mekkadrill	Gelbin Mekkatorque
Leeroy Jenkins	Leeroy Jenkins
Ausweiden	Eviscerate
Verrat	Betrayal
Verhüllen	Conceal
Dolchfächer	Fan of Knives
Heldenopfer	Noble Sacrifice
Rädelsführer der Defias	Defias Ringleader
Auge um Auge	Eye for an Eye
Klinge des Verderbens	Perdition's Blade
SI:7-Agent	SI:7 Agent
Erlösung	Redemption
Schädelbruch	Headcrack
Schattenschritt	Shadowstep
Vorbereitung	Preparation
Zorn	Wrath
Mal der Natur	Mark of Nature
Seele des Waldes	Soul of the Forest
Macht der Wildnis	Power of the Wild
Kreislauf der Natur	Naturalize
Terrorwolfalpha	Dire Wolf Alpha
Pflege	Nourish
Druide der Klaue	Druid of the Claw
Hüter des Hains	Keeper of the Grove
Anregen	Innervate
Kaiserkobra	Emperor Cobra
Sternenfeuer	Starfire
Urtum des Krieges	Ancient of War
Blitzschlag	Lightning Bolt
Lavaeruption	Lava Burst
Staubteufel	Dust Devil
Macht der Totems	Totemic Might
Erdschock	Earth Shock
Verhexung	Hex
Sturmgeschmiedete Axt	Stormforged Axe
Wildgeist	Feral Spirit
Baron Geddon	Baron Geddon
Erdelementar	Earth Elemental
Gabelblitzschlag	Forked Lightning
Entfesselter Elementar	Unbound Elemental
Gewittersturm	Lightning Storm
Astraler Arkanist	Ethereal Arcanist
Kältekegel	Cone of Cold
Arkane Geschosse	Arcane Missiles
Tückische Klinge	Shiv
Pyroschlag	Pyroblast
Frostelementar	Frost Elemental
Azurblauer Drache	Azure Drake
Gegenzauber	Counterspell
Eisbarriere	Ice Barrier
Spiegelgestalt	Mirror Entity
Eisblock	Ice Block
Ragnaros der Feuerfürst	Ragnaros the Firelord
Teufelswache	Felguard
Weltliche Ängste	Mortal Coil
Schattenflamme	Shadowflame
Schrecken der Leere	Void Terror
Sukkubus	Succubus
Seelenfeuer	Soulfire
Seele entziehen	Siphon Soul
Verdammniswache	Doomguard
Wirbelnder Nether	Twisting Nether
Grubenlord	Pit Lord
Beschwörungsportal	Summoning Portal
Überwältigende Macht	Power Overwhelming
Dämonen wahrnehmen	Sense Demons
Flammenwichtel	Flame Imp
Omen der Verdammnis	Bane of Doom
Lord Jaraxxus	Lord Jaraxxus
Stille	Silence
Dunkler Wahnsinn	Shadow Madness
Lichtbrut	Lightspawn
Gedankenraub	Thoughtsteal
Lichtbrunnen	Lightwell
Gedankenspiele	Mindgames
Göttliche Gunst	Divine Favor
Prophet Velen	Prophet Velen
Handauflegung	Lay on Hands
Gesegneter Champion	Blessed Champion
Demut	Humility
Argentumbeschützer	Argent Protector
Segen der Weisheit	Blessing of Wisdom
Heiliger Zorn	Holy Wrath
Schwert der Gerechtigkeit	Sword of Justice
Hand des Schutzes	Hand of Protection
Buße	Repentance
Friedensbewahrer	Aldor Peacekeeper
Tirion Fordring	Tirion Fordring
Zornige Vergeltung	Avenging Wrath
Taurenkrieger	Tauren Warrior
Zerschmettern	Slam
Kampfeswut	Battle Rage
Amaniberserker	Amani Berserker
Wächter von Mogu'shan	Mogu'shan Warden
Arathiwaffenschmiedin	Arathi Weaponsmith
Gurubashiberserker	Gurubashi Berserker
Wirbelwind	Whirlwind
Rüstungsschmiedin	Armorsmith
Schildträger	Shieldbearer
Scharmützel	Brawl
Tödlicher Stoß	Mortal Strike
Aufwertung	Upgrade!
Schildschlag	Shield Slam
Blutschrei	Gorehowl
Tobender Worgen	Raging Worgen
Grommash Höllschrei	Grommash Hellscream
Murlocgezeitenjäger	Murloc Tidehunter
Murlocanführer	Murloc Warleader
Grimmschuppenorakel	Grimscale Oracle
Murlocgezeitenrufer	Murloc Tidecaller
Geduldiger Attentäter	Patient Assassin
Aasfressende Hyäne	Scavenging Hyena
Irreführung	Misdirection
Savannenhochmähne	Savannah Highmane
Adlerhornbogen	Eaglehorn Bow
Explosivschuss	Explosive Shot
Lasst die Hunde los!	Unleash the Hounds
Fass!	Kill Command
König Knirsch	King Krush
Leuchtfeuer	Flare
Zorn des Wildtiers	Bestial Wrath
Schlangenfalle	Snake Trap
Erntegolem	Harvest Golem
Nat Pagle	Nat Pagle
Harrison Jones	Harrison Jones
Erzmagier Antonidas	Archmage Antonidas
Nozdormu	Nozdormu
Alexstrasza	Alexstrasza
Onyxia	Onyxia
Malygos	Malygos
Gesichtsloser Manipulator	Faceless Manipulator
Flammenzungentotem	Flametongue Totem
Schicksalshammer	Doomhammer
Biss	Bite
Naturgewalt	Force of Nature
Ysera	Ysera
Cenarius	Cenarius
Manafluttotem	Mana Tide Totem
Die Bestie	The Beast
Unbändigkeit	Savagery
Kopfnuss	Sap
Magier von Dalaran	Dalaran Mage
Priesterin von Elune	Priestess of Elune
Uralter Magier	Ancient Mage
Meeresriese	Sea Giant
Windsprecher	Windspeaker
Blutritter	Blood Knight
Auchenaiseelenpriesterin	Auchenai Soulpriest
Nachtklinge	Nightblade
Zerstäuben	Vaporize
Kultmeisterin	Cult Master
Dämonenfeuer	Demonfire
Wichtelmeisterin	Imp Master
Fieser Zuchtmeister	Cruel Taskmaster
Wütender Berserker	Frothing Berserker
Schildblock	Shield Block
Innere Wut	Inner Rage
Zauberlehrling	Sorcerer's Apprentice
Scharfschießen	Snipe
Sprengfalle	Explosive Trap
Eiskältefalle	Freezing Trap
Magierin der Kirin Tor	Kirin Tor Mage
Edwin van Cleef	Edwin VanCleef
Illidan Sturmgrimm	Illidan Stormrage
Managespenst	Mana Wraith
Tödlicher Schuss	Deadly Shot
Gleichheit	Equality
Geschmolzener Riese	Molten Giant
Kreis der Heilung	Circle of Healing
Schattenwort: Tod	Shadow Word: Death
Vollstrecker des Tempels	Temple Enforcer
Heiliges Feuer	Holy Fire
Schattengestalt	Shadowform
Massenbannung	Mass Dispel
Zombiefraß	Zombie Chow
Geisterhafter Krabbler	Haunted Creeper
Echoschlamm	Echoing Ooze
Irrer Wissenschaftler	Mad Scientist
Naxxramasschemen	Shade of Naxxramas
Nerubisches Ei	Nerubian Egg
Spektraler Ritter	Spectral Knight
Todesfürst	Deathlord
Maexxna	Maexxna
Netzweber	Webspinner
Schlickspucker	Sludge Belcher
Kel'Thuzad	Kel'Thuzad
Stalagg	Stalagg
Feugen	Feugen
Klagende Seele	Wailing Soul
Netzfürst der Nerub'ar	Nerub'ar Weblord
Duplizieren	Duplicate
Giftsamen	Poison Seeds
Rächer	Avenge
Biss des Todes	Death's Bite
Leerrufer	Voidcaller
Dunkler Kultist	Dark Cultist
Instabiler Ghul	Unstable Ghoul
Reinkarnation	Reincarnate
Wegelagerer der Anub'ar	Anub'ar Ambusher
Steinhautgargoyle	Stoneskin Gargoyle
Totengräber	Undertaker
Tanzende Schwerter	Dancing Swords
Loatheb	Loatheb
Baron Totenschwur	Baron Rivendare
Flammenkanone	Flamecannon
Schneefresser	Snowchugger
Instabiles Portal	Unstable Portal
Goblinsprengmagier	Goblin Blastmage
Echo von Medivh	Echo of Medivh
Mechwarper	Mechwarper
Flammenleviathan	Flame Leviathan
Lichtbombe	Lightbomb
Schattenbomberin	Shadowbomber
Velens Auserwählter	Velen's Chosen
Schrumpfmeister	Shrinkmeister
Licht der Naaru	Light of the Naaru
Ritzelmeister	Cogmaster
Vol'jin	Vol'jin
Dunkelbombe	Darkbomb
Teufelshäscher	Fel Reaver
Begleiter rufen	Call Pet
Herrin der Schmerzen	Mistress of Pain
Dämonenherz	Demonheart
Teufelskanone	Fel Cannon
Mal'Ganis	Mal'Ganis
Schärföl des Tüftlers	Tinker's Sharpsword Oil
Goblinbarbier-o-Mat	Goblin Auto-Barber
Ritzelschraubenschlüssel	Cogmaster's Wrench
Einäugiger Schwindler	One-eyed Cheat
Totstellen	Feign Death
Eiserner Sensei	Iron Sensei
Handelsprinz Gallywix	Trade Prince Gallywix
Ruf der Urahnen	Ancestor's Call
Eloxiertes Robobärchen	Anodized Robo Cub
Wiederverwerten	Recycle
Hüterin des Hains	Grove Tender
Baum des Lebens	Tree of Life
Mech-Bär-Katze	Mech-Bear-Cat
Malorne	Malorne
Streitantriebskolben	Powermace
Wirbelnder Zapp-o-Mat	Whirling Zap-o-matic
Knistern	Crackle
Totem der Vitalität	Vitality Totem
Murlocgeistwandler	Siltfin Spiritwalker
Dunkle Einflüsterung	Dark Wispers
Neptulon	Neptulon
Glevehr	Glaivezooka
Spinnenpanzer	Spider Tank
Wichtelexplosion	Imp-losion
König der Wildtiere	King of Beasts
Sabotage	Sabotage
Metallzahnspringer	Metaltooth Leaper
Gahz'rilla	Gahz'rilla
Sausendes Sägeblatt	Bouncing Blade
Kriegsbot	Warbot
Zermalmen	Crush
Schildmaid	Shieldmaiden
Ogertotschläger	Ogre Warmaul
Mörderische Rostlaube	Screwjank Clunker
Eiserner Koloss	Iron Juggernaut
Siegel des Lichts	Seal of Light
Abgeschirmter Minibot	Shielded Minibot
Zahnradhammer	Coghammer
Rüstmeister	Quartermaster
Ruf zu den Waffen	Muster for Battle
Kobaltwächter	Cobalt Guardian
Bolvar Fordragon	Bolvar Fordragon
Pfützenstampfer	Puddlestomper
Ogerschläger	Ogre Brute
Dünenbrecherschamane	Dunemaul Shaman
Splittersteintrogg	Stonesplinter Trogg
Felsenkiefertrogg	Burly Rockjaw Trogg
Antiker Heilbot	Antique Healbot
Seebär	Salty Dog
Verirrter Weitschreiter	Lost Tallstrider
Schattenboxer	Shadowboxer
Kobraschuss	Cobra Shot
Mystikerin von Kezan	Kezan Mystic
Schiffskanone	Ship's Cannon
Explosives Schaf	Explosive Sheep
Animagolem	Anima Golem
Mechanischer Yeti	Mechanical Yeti
Angriffspanzer MAX	Force-Tank MAX
Druide des Giftzahns	Druid of the Fang
Gilblinpirscher	Gilblin Stalker
Aufziehgnom	Clockwork Gnome
Reparaturbot 2.0	Upgraded Repair Bot
Flugmaschine	Flying Machine
Nerv-o-Tron	Annoy-o-Tron
Belagerungsmaschine	Siege Engine
Dampfdruckschütze	Steamwheedle Sniper
Ninjaoger	Ogre Ninja
Illuminatorin	Illuminator
Wahnsinniger Bomber	Madder Bomber
Arkannullifizierer X-21	Arcane Nullifier X-21
Gnomenversuchsleiter	Gnomish Experimenter
Zielattrappe	Target Dummy
Jeeves	Jeeves
Goblinpionier	Goblin Sapper
Bemannter Schredder	Piloted Shredder
Winzige Exorzistin	Lil' Exorcist
Soldat von Gnomeregan	Gnomeregan Infantry
Bombenwerfer	Bomb Lobber
Schwebender Beobachter	Floating Watcher
Scharlachroter Läuterer	Scarlet Purifier
Tüftelstadttechniker	Tinkertown Technician
Mikromaschine	Micro Machine
Hobgoblin	Hobgoblin
Bemannter Himmelsgolem	Piloted Sky Golem
Schrottbot	Junkbot
Aufwert-o-Bot	Enhance-o Mechano
Rekombobulator	Recombobulator
Minimagier	Mini-Mage
Dr. Bumm	Dr. Boom
Mimirons Kopf	Mimiron's Head
Mogor der Oger	Mogor the Ogre
Feindschnitter 4000	Foe Reaper 4000
Sneeds alter Schredder	Sneed's Old Shredder
Toshley	Toshley
Robogenieur Thermadraht	Mekgineer Thermaplugg
Gazlowe	Gazlowe
Troggzor der Erdinator	Troggzor the Earthinator
Blingtron 3000	Blingtron 3000
Hemet Nesingwary	Hemet Nesingwary
Aufziehgigant	Clockwork Giant
Kleine Zauberblockerin	Wee Spellstopper
Rußspeier	Soot Spewer
Garrosh Höllschrei	Garrosh Hellscream
Magni Bronzebart	Magni Bronzebeard
Thrall	Thrall
Morgl das Orakel	Morgl the Oracle
Valeera Sanguinar	Valeera Sanguinar
Maiev Schattensang	Maiev Shadowsong
Uther Lichtbringer	Uther Lightbringer
Lady Liadrin	Lady Liadrin
Prinz Arthas	Prince Arthas
Rexxar	Rexxar
Alleria Windläufer	Alleria Windrunner
Malfurion Sturmgrimm	Malfurion Stormrage
Gul'dan	Gul'dan
Nemsy Nimmertot	Nemsy Necrofizzle
Jaina Prachtmeer	Jaina Proudmoore
Medivh	Medivh
Khadgar	Khadgar
Anduin Wrynn	Anduin Wrynn
Tyrande Wisperwind	Tyrande Whisperwind
Phantomfreibeuterin	Phantom Freebooter
Skelemant	Skelemancer
Explosive Fledermaus	Exploding Bloatbat
Schneewatschler	Snowflipper Penguin
Rasselnder Rabauke	Rattling Rascal
Grimmige Nekromantin	Grim Necromancer
Knochendrache	Bone Drake
Sonnengeborene Val'kyr	Sunborne Val'kyr
Kobaltblaue Bannschuppe	Cobalt Scalebane
Nachtheuler	Night Howler
Giftwirkerin	Venomancer
Eingebildeter Kreuzritter	Arrogant Crusader
Lautere Beschützerin	Righteous Protector
Finsteres Urteil	Dark Conviction
Entweihen	Defile
Schicksalsspinnerin	Fatespinner
Toxischer Pfeil	Toxic Arrow
Spinnennetz	Webweave
Druidin des Schwarms	Druid of the Swarm
Tot spielen	Play Dead
Seuchenherd	Spreading Plague
Seelendieb	Drain Soul
Kryostase	Cryostasis
Brrrloc	Brrrloc
Bergfeuerrüstung	Mountainfire Armor
Blutklinge	Blood Razor
Knochenbaron	Bone Baron
Vryghul	Vryghoul
Eiswandler	Ice Walker
Grausige Beschwörerin	Ghastly Conjurer
Lichtschmerz	Light's Sorrow
Übler Schreckenslord	Despicable Dreadlord
Lawine	Avalanche
Zäher Brocken	Gnash
Drakkari-Verteidiger	Drakkari Defender
Frostklon	Frozen Clone
Todgeweihter Lehrling	Doomed Apprentice
Üble Verseuchung	Ultimate Infestation
Gletschermysterien	Glacial Mysteries
Voodoo-Verhexerin	Voodoo Hexxer
Eisfischen	Ice Fishing
Schneegrollriese	Snowfury Giant
Hand des toten Mannes	Dead Man's Hand
Acherus-Veteranin	Acherus Veteran
Tuskarrfischer	Tuskarr Fisherman
Gefallene Klerikerin	Fallen Sun Cleric
Schmelzofenkoloss	Furnacefire Colossus
Grabschrecken	Grave Shambler
Gruftlauerer	Tomb Lurker
Tickende Monstrosität	Ticking Abomination
Giftbissfalle	Venomstrike Trap
Knochenorakel	Roll the Bones
Professor Seuchenmord	Professor Putricide
Verraten und verkauft	Treachery
Verstand rauben	Devour Mind
Schattenaszendentin	Shadow Ascendant
Akolyth der Pein	Acolyte of Agony
Ewige Knechtschaft	Eternal Servitude
Obsidianstatue	Obsidian Statue
Erzbischof Benedictus	Archbishop Benedictus
Heulbestie	Howlfiend
Todesschuppenritter	Deadscale Knight
Egelgift	Leeching Poison
Waffenwurf	Doomerang
Schattenessenz	Shadow Essence
Eisbrecher	Ice Breaker
Erweckter Berserker	Animated Berserker
Spuk der Runenschmiede	Runeforge Haunter
Leichenspinne	Corpse Widow
Schiere Verzweiflung	Desperate Stand
Schwarzwache	Blackguard
Eisgespenst	Coldwraith
Leichenerwecker	Corpse Raiser
Seelenschmiede	Forge of Souls
Moorabi	Moorabi
Der Lichkönig	The Lich King
Modermiene	Rotface
Gnomferatu	Gnomeferatu
Val'kyr-Seelenfängerin	Val'kyr Soulclaimer
Grotesker Fährtenleser	Stitched Tracker
Haibär	Bearshark
Klagegeist des Todes	Death Revenant
Saronitzwangsarbeiter	Saronite Chain Gang
Todesverkünder	Deathspeaker
Elender Bauer	Wretched Tiller
Widerwilliges Opfer	Unwilling Sacrifice
Todesseher Thrall	Thrall, Deathseer
Glücklicher Ghul	Happy Ghoul
Schleichender Spuk	Skulking Geist
Expressbestatterin	Shallow Gravedigger
Knochenross	Bonemare
Nerubischer Zerreißer	Nerubian Unraveler
Frostige Kommandantin	Howling Commander
Seelensog	Spirit Lash
Panzerplünderer	Strongshell Scavenger
Gruftlord	Crypt Lord
Seuchenforscher	Plague Scientist
Todesaxtbestrafer	Deathaxe Punisher
Lilian Voss	Lilian Voss
Fleischwagen	Meat Wagon
Frostklingenchampion	Chillblade Champion
Simulakrum	Simulacrum
Monströser Bogenschütze	Abominable Bowman
Valeera die Bleiche	Valeera the Hollow
Todespirscher Rexxar	Deathstalker Rexxar
Uther der Schwarzen Klinge	Uther of the Ebon Blade
Schattenhäscher Anduin	Shadowreaper Anduin
Bluthäscher Gul'dan	Bloodreaver Gul'dan
Malfurion der Befallene	Malfurion the Pestilent
Frostlich Jaina	Frost Lich Jaina
Geißelfürst Garrosh	Scourgelord Garrosh
Hadronox	Hadronox
Sindragosas Hauch	Breath of Sindragosa
Versucht es nur!	Bring It On!
Sindragosa	Sindragosa
Blutkönigin Lana'thel	Blood-Queen Lana'thel
Die dunkle Seite	Embrace Darkness
Schattenklinge	Shadowblade
Prinz Keleseth	Prince Keleseth
Prinz Taldaram	Prince Taldaram
Prinz Valanar	Prince Valanar
Der Lichköter	Arfus
Hyldnir-Frostreiterin	Hyldnir Frostrider
Spruchweberin	Spellweaver
Bolvar Feuerblut	Bolvar, Fireblood
Nekrotischer Spuk	Necrotic Geist
Drakkari-Verzauberin	Drakkari Enchanter
Geistbrecher	Mindbreaker
Blutberauschter Elf	Sanguine Reveler
Wahnsinniges Skelett	Wicked Skeleton
Blutwurm	Bloodworm
Spektrale Plünderin	Spectral Pillager
Wehklagende Banshee	Keening Banshee
Leichenfledderin	Corpsetaker
Besudelte Zelotin	Tainted Zealot
Katze aus dem Hut	Cat Trick
Großmütterchen	Kindly Grandmother
Vermummte Jägerin	Cloaked Huntress
Brabbelndes Buch	Babbling Book
Nachtschreckentemplerin	Nightbane Templar
Schwülstiger Mime	Pompous Thespian
Läutern	Purify
Böse Hexendoktorin	Wicked Witchdoctor
Kara Kazham!	Kara Kazham!
Beschützt den König!	Protect the King!
Fluch des Narren	Fool's Bane
Runenverziertes Ei	Runic Egg
Hausspinne	Pantry Spider
Bücherwyrm	Book Wyrm
Priester Nimmersatt	Priest of the Feast
Arkananomalie	Arcane Anomaly
Wächtereule	Avian Watcher
Grabenlauerer	Moat Lurker
Moroes	Moroes
Elfenbeinspringer	Ivory Knight
Der Kurator	The Curator
Nethergrollhistorikerin	Netherspite Historian
Geisterklauen	Spirit Claws
Menageriewächterin	Menagerie Warden
Piratengauner	Swashburglar
Astraler Hehler	Ethereal Peddler
Portal: Mahlstrom	Maelstrom Portal
Portal: Mondlichtung	Moonglade Portal
Portal: Feuerlande	Firelands Portal
Portal: Silbermond	Silvermoon Portal
Malchezaars Wichtel	Malchezaar's Imp
Portal: Eisenschmiede	Ironforge Portal
Medivhs Kammerdiener	Medivh's Valet
Tödliche Gabel	Deadly Fork
Zoobot	Zoobot
Prinz Malchezaar	Prince Malchezaar
Medivh der Wächter	Medivh, the Guardian
Barnes	Barnes
Onyxläufer	Onyx Bishop
Tafelsilbergolem	Silverware Golem
Verzauberter Rabe	Enchanted Raven
Menageriemagier	Menagerie Magician
Arkanschmied	Arcanosmith
Arkanriese	Arcane Giant
Violette Illusionistin	Violet Illusionist
Vergessene Fackel	Forgotten Torch
Astraler Beschwörer	Ethereal Conjurer
Museumswärter	Museum Curator
Rafaams Fluch	Curse of Rafaam
Obsidianzerstörer	Obsidian Destroyer
Grubenschlange	Pit Snake
Reno Jackson	Reno Jackson
Gruftplünderer	Tomb Pillager
Rumpelnder Elementar	Rumbling Elemental
Hüterin von Uldaman	Keeper of Uldaman
Tunneltrogg	Tunnel Trogg
Ausgegrabener Raptor	Unearthed Raptor
Wüstenkamel	Desert Camel
Pfeilfalle	Dart Trap
Affe mit Waffe	Fierce Monkey
Unheimlicher Trödler	Dark Peddler
Rückkehr der Verflossenen	Anyfin Can Happen
Heilige Prüfung	Sacred Trial
Juwelenskarabäus	Jeweled Scarab
Meerhexe der Naga	Naga Sea Witch
Gorillabot A-3	Gorillabot A-3
Riesenkröte	Huge Toad
Gruftspinne	Tomb Spider
Gesattelter Raptor	Mounted Raptor
Dschungel-Mondkin	Jungle Moonkin
Dschinn der Zephyre	Djinni of Zephyrs
Wächter des Anubisath	Anubisath Sentinel
Fossiler Teufelssaurier	Fossilized Devilsaur
Sir Finley Mrrgglton	Sir Finley Mrrgglton
Brann Bronzebart	Brann Bronzebeard
Elise Sternensucher	Elise Starseeker
Beschwörungsstein	Summoning Stone
Wackelige Wichte	Wobbling Runts
Meisterdieb Rafaam	Arch-Thief Rafaam
Lebendig begraben	Entomb
Forscherhut	Explorer's Hat
Unheimliche Statue	Eerie Statue
Uralter Schemen	Ancient Shade
Freigelegtes Unheil	Excavated Evil
Famose Flossengenossen	Everyfin is Awesome
Rabengötze	Raven Idol
Archäologin der Akademie	Reliquary Seeker
Verfluchte Klinge	Cursed Blade
Belebte Rüstung	Animated Armor
Miniflosse	Murloc Tinyfin
Psychischer Schrei	Psychic Scream
Vulgärer Homunculus	Vulgar Homunculus
Koboldbibliothekar	Kobold Librarian
Düsterer Pakt	Dark Pact
Hakenbewehrter Häscher	Hooked Reaver
Schreiter der Fal'dorei	Fal'dorei Strider
Glitzergrabscherin	Cavern Shinyfinder
Koboldbarbar	Kobold Barbarian
Geringer Zauberamethyst	Lesser Amethyst Spellstone
Klingenstumpf	Bladed Gauntlet
Baumrinde	Barkskin
Eisenholzgolem	Ironwood Golem
Geringer Zauberjaspis	Lesser Jasper Spellstone
Am Scheideweg	Branching Paths
Astraltiger	Astral Tiger
Zerquetschende Hand	Crushing Hand
Koboldeinsiedler	Kobold Hermit
Geringer Zaubersaphir	Lesser Sapphire Spellstone
Schmuddeliger Klobold	Sewer Crawler
Flankenangriff	Flanking Strike
Höhlenhydra	Cave Hydra
Monsterköder	Wandering Monster
Geringer Zaubersmaragd	Lesser Emerald Spellstone
Rhok'delar	Rhok'delar
Trank des Heldenmuts	Potion of Heroism
Geringe Zauberperle	Lesser Pearl Spellstone
Auf in die Schlacht!	Call to Arms
Explosive Runen	Explosive Runes
Geringer Zauberrubin	Lesser Ruby Spellstone
Wandelbare Schriftrolle	Shifting Scroll
Deck der Wunder	Deck of Wonders
Aluneth	Aluneth
Skorp-o-matik	Scorp-o-matic
Wachselementar	Wax Elemental
Schwarzer Drachenschmied	Ebon Dragonsmith
Ätzender Schlick	Corrosive Sludge
Einzelkämpfer	Lone Champion
Steinhautbasilisk	Stoneskin Basilisk
Arkantyrann	Arcane Tyrant
Grüner Glibber	Green Jelly
Drachentöterin	Dragonslayer
Bissige Truhe	Toothy Chest
Verschlagenes Teufelchen	Sneaky Devil
Schläfriger Drache	Sleepy Dragon
Hortender Drache	Hoarding Dragon
Katakombenkriecher	Corridor Creeper
Furbolgmoosbinder	Furbolg Mossbinder
Unbekümmerte Bardin	Boisterous Bard
Violetter Wurm	Violet Wurm
Bruchschnauzenritter	Gravelsnout Knight
Fleischfressender Würfel	Carnivorous Cube
Sonya Schattentänzer	Sonya Shadowdancer
Fungumant	Fungalmancer
Rabenvertrauter	Raven Familiar
Zorn des Drachen	Dragon's Fury
Silberne Wegbereiterin	Silver Vanguard
Ruf des Zwielichts	Twilight's Call
Schimmerndes Ross	Shimmering Courser
Geringes Zaubermithril	Lesser Mithril Spellstone
Von der Schippe springen	Cheat Death
Drachenseele	Dragon Soul
Plötzlicher Verrat	Sudden Betrayal
Elfischer Minnesänger	Elven Minstrel
Entrinnen	Evasion
Lynessa Sonnenleid	Lynessa Sunsorrow
Zu mir!	To My Side!
Garstiger Brabbler	Feral Gibberer
Kerzenbogen	Candleshot
Arkankonstrukteur	Arcane Artificer
Verfluchter Jünger	Cursed Disciple
Düstermaulwurf	Dire Mole
Unidentifiziertes Elixier	Unidentified Elixir
Unidentifizierter Schild	Unidentified Shield
Unidentifizierter Hammer	Unidentified Maul
Pilzbrauer	Shroom Brewer
Besessener Lakai	Possessed Lackey
Eichenranken	Oaken Summons
Kristalllöwe	Crystal Lion
Bärbeißiger Wächter	Grizzled Guardian
Pilzversessener Trogg	Trogg Gloomeater
Pilzfürst Ixlid	Ixlid, Fungal Lord
Stufenaufstieg!	Level Up!
Primitive Talismane	Primal Talismans
Koboldlehrling	Kobold Apprentice
Gieriger Waldgeist	Greedy Sprite
Psionischer Blick	Psionic Probe
Marin der Fuchs	Marin the Fox
Groll der Weltenrüttler	Grumble, Worldshaker
Staubwindkerkermeister	Drygulch Jailor
Rundumschlag	Reckless Flurry
Juwelenbesetzter Golem	Gemstudded Golem
Trockenstoppelschmied	Drywhisker Armorer
Leerenfürst	Voidlord
Gruppensuche	Gather Your Party
Heilender Regen	Healing Rain
Gildenrekrutiererin	Guild Recruiter
Unheilsbringer	Woecleaver
Koboldmönch	Kobold Monk
Hungriger Ettin	Hungry Ettin
Fungusverzauberer	Fungal Enchanter
Stöbernder Kobold	Rummaging Kobold
Zweig des Weltenbaums	Twig of the World Tree
Schreischwammerl	Shrieking Shroom
Wohlwollender Dschinn	Benevolent Djinn
Zwielichtbrecher	Duskbreaker
Koboldillusionist	Kobold Illusionist
Panzerkäfer	Plated Beetle
Großarchivar	Grand Archivist
Erste Jüngerin Rin	Rin, the First Disciple
Kataklysmus	Cataclysm
Schädel der Man'ari	Skull of the Man'ari
Val'anyr	Val'anyr
Geringer Zauberonyx	Lesser Onyx Spellstone
Instabile Evolution	Unstable Evolution
Der Runenspeer	The Runespear
Geringer Zauberdiamant	Lesser Diamond Spellstone
Kathrena Winterleuchten	Kathrena Winterwisp
Zola die Gorgone	Zola the Gorgon
Brausender Elementar	Murmuring Elemental
Scherwindsturmrufer	Windshear Stormcaller
Geoformerin Yip	Geosculptor Yip
Sickernder Schleimling	Seeping Oozeling
Meister Eichenherz	Master Oakheart
Die Wände kommen näher!	Crushing Walls
Die Dunkelheit	The Darkness
Zwielichtakolyth	Twilight Acolyte
Leerenreißer	Void Ripper
Goldener Gargoyle	Gilded Gargoyle
Drachenruferin Alanna	Dragoncaller Alanna
Leylinienmanipulator	Leyline Manipulator
Temporus	Temporus
Boshafte Beschwörerin	Spiteful Summoner
Drachenbrutwächter	Dragonhatcher
König Togwaggel	King Togwaggle
Königsbann	Kingsbane
Opferpakt	Sacrificial Pact
Verschwinden	Vanish
Entführer	Kidnapper
Sternenregen	Starfall
Urtum der Lehren	Ancient of Lore
Al'Akir der Windlord	Al'Akir the Windlord
Elitesoldat der Kor'kron	Kor'kron Elite
Manawyrm	Mana Wyrm
Meisterin der Tarnung	Master of Disguise
Papagei des Kapitäns	Captain's Parrot
Hungrige Krabbe	Hungry Crab
Blutsegelräuberin	Bloodsail Raider
Messerjongleur	Knife Juggler
Wilder Pyromant	Wild Pyromancer
Untergangsverkünder	Doomsayer
Schreckenskorsar	Dread Corsair
Feendrache	Faerie Dragon
Kapitän Grünhaut	Captain Greenskin
Blutsegelkorsar	Bloodsail Corsair
Violette Ausbilderin	Violet Teacher
Südmeerkapitän	Southsea Captain
Millhaus Manasturm	Millhouse Manastorm
Todesschwinge	Deathwing
Tierbegleiter	Animal Companion
Befehlsruf	Commanding Shout
Meisterschwertschmied	Master Swordsmith
Gruul	Gruul
Hogger	Hogger
Panischer Kodo	Stampeding Kodo
Murlocinquisitor	Vilefin Inquisitor
Urtümliche Fusion	Primal Fusion
Gesichtsloser Pyromane	Flamewreathed Faceless
Ewiger Wächter	Eternal Sentinel
Evolution	Evolve
Ding aus der Tiefe	Thing from Below
Der Schattenhammer	Hammer of Twilight
Tentakel statt Arme	Tentacles for Arms
Silithidschwärmer	Silithid Swarmer
Y'Shaarj, Unbändige Wut	Y'Shaarj, Rage Unbound
Fandral Hirschhaupt	Fandral Staghelm
Verseuchen	Infest
Wilde Wut	Feral Rage
Y'Shaarjs Mal	Mark of Y'Shaarj
Verbotenes Urtum	Forbidden Ancient
Auf der Jagd	On the Hunt
Klingenkultist	Bladed Cultist
Reise in die Tiefe	Journey Below
Disteltee	Thistle Tea
Xaril, Vergifteter Geist	Xaril, Poisoned Mind
Zertrümmern	Shatter
Mutierter Kobold	Evolved Kobold
Zwielichtflammenrufer	Twilight Flamecaller
Wahnsinniger Frostrufer	Demented Frostcaller
Verbotene Flamme	Forbidden Flame
Diener von Yogg-Saron	Servant of Yogg-Saron
Kabalistenfoliant	Cabalist's Tome
Machtwort: Tentakel	Power Word: Tentacles
Zwielichtdunkelheilerin	Twilight Darkmender
Schattenwort: Schrecken	Shadow Word: Horror
Verbotene Schöpfung	Forbidden Shaping
Dunkelsprecher	Darkspeaker
Schattenhingabe	Embrace the Shadow
Dunkelhain-Gelehrte	Darkshire Librarian
Dunkelhain-Ratsherr	Darkshire Councilman
Verbotenes Ritual	Forbidden Ritual
Grassierender Wahn	Spreading Madness
Abkehr von der Dunkelheit	Renounce Darkness
Anomalus	Anomalus
Cho'gall	Cho'gall
Mukla, Tyrann des Tals	Mukla, Tyrant of the Vale
Gestaltwandler Zerus	Shifter Zerus
Imperator Vek'lor	Twin Emperor Vek'lor
N'Zoth, der Verderber	N'Zoth, the Corruptor
Yogg-Saron, Hoffnungsende	Yogg-Saron, Hope's End
Nerubischer Prophet	Nerubian Prophet
Gesichtsloses Ungetüm	Faceless Behemoth
Unheimlicher Schrecken	Eldritch Horror
Psych-o-Tron	Psych-o-Tron
Verderbter Heilbot	Corrupted Healbot
Zerstörerischer Ghul	Ravaging Ghoul
Entstellter Berserker	Aberrant Berserker
Tentakel von N'Zoth	Tentacle of N'Zoth
Grotesker Drachenfalke	Grotesque Dragonhawk
Moorschleicher	Bog Creeper
Gallflossengezeitenjäger	Bilefin Tidehunter
Eifriger Initiand	Zealous Initiate
Verderbter Seher	Corrupted Seer
Jünger von C'Thun	Disciple of C'Thun
Blut des Uralten	Blood of The Ancient One
Gesichtsloser Schlurfer	Faceless Shambler
Schattenschlag	Shadow Strike
Feurige Fledermaus	Fiery Bat
Bernweber der Klaxxi	Klaxxi Amber-Weaver
Verderbte Irrwische	Wisps of the Old Gods
Verbotene Heilung	Forbidden Healing
Triumphierender Verkünder	Validated Doomsayer
Hüter des Morasts	Mire Keeper
Donnerkrachen	Stormcrack
Gesichtsloser Beschwörer	Faceless Summoner
Hallazeal der Aufgestiegene	Hallazeal the Ascended
Ruf der Wildnis	Call of the Wild
Befallener Wolf	Infested Wolf
Kriegerheld der Bluthufe	Bloodhoof Brave
Malkorok	Malkorok
Selbstlose Heldin	Selfless Hero
Klinge des Ansporns	Rallying Blade
Göttliche Stärke	Divine Strength
Ragnaros der Lichtfürst	Ragnaros, Lightlord
Dunkelhain-Alchemistin	Darkshire Alchemist
VERDAMMNIS!	DOOM!
Besessener Dorfbewohner	Possessed Villager
Mutierter Worgen	Twisted Worgen
Am'gam-Wüter	Am'gam Rager
Infizierter Tauren	Infested Tauren
Geheimniszehrer	Eater of Secrets
Verdammnisrufer	Doomcaller
Brut von N'Zoth	Spawn of N'Zoth
Südmeer-Tentakelbart	Southsea Squidface
Geschuppter Alptraum	Scaled Nightmare
Zwielichtbeschwörer	Twilight Summoner
Vereint gegen das Dunkel	Stand Against Darkness
Blutkrieger	Blood Warriors
C'Thun	C'Thun
Beschwörerin des Bösen	Beckoner of Evil
Klinge von C'Thun	Blade of C'Thun
C'Thuns Auserwählte	C'Thun's Chosen
Zwielichtgeomantin	Twilight Geomancer
Zwielichtältester	Twilight Elder
Uralte Vorbotin	Ancient Harbinger
Schattenwirkerin	Shadowcaster
Einsamer Pirscher	Forlorn Stalker
Dunkler Arakkoa	Dark Arakkoa
Apotheker des Kults	Cult Apothecary
Der Alptraumschlinger	The Boogeymonster
Uralte Schildträgerin	Ancient Shieldbearer
Seelenführerin	Usher of Souls
Zauberin des Kults	Cult Sorcerer
Riesiger Sandwurm	Giant Sand Worm
Prinzessin Huhuran	Princess Huhuran
Dunkelhain-Statthalterin	Steward of Darkshire
Licht in der Dunkelheit	A Light in the Darkness
N'Zoths Erster Maat	N'Zoth's First Mate
Gestörter Grizzly	Addled Grizzly
Blut zu Sekret	Blood To Ichor
Blutsegelkultistin	Bloodsail Cultist
Herold Volazj	Herald Volazj
Drachenlord Todesschwinge	Deathwing, Dragonlord
Hogger, Geißel von Elwynn	Hogger, Doom of Elwynn
Mitternachtsdrache	Midnight Drake
Wahnsinniger Anbeter	Crazed Worshipper
Schwarzmeerpiratin	Blackwater Pirate
Verseuchter Hamsterer	Polluted Hoarder
Aaslarve	Carrion Grub
Düstereber	Duskboar
Zuckendes Tentakel	Squirming Tentacle
Meister der Evolution	Master of Evolution
Hehler aus Unterstadt	Undercity Huckster
Okkulte Akolythin	Hooded Acolyte
Flüchtiger Schemen	Shifting Shade
Schreckenszyklop	Cyclopian Horror
Nat der Dunkelfischer	Nat, the Darkfisher
Kultist von Skeram	Skeram Cultist
Soggoth der Glitschige	Soggoth the Slitherer
Elite Tauren Chieftain	Elite Tauren Chieftain
Fleischfressender Ghul	Flesheating Ghoul
Zauberformerin	Spellbender
Pterrordaxjunges	Pterrordax Hatchling
Vulkanosaurus	Volcanosaur
Dinogröße	Dinosize
Mickriger Ravasaurus	Ravasaur Runt
Gesättigter Dreschadon	Sated Threshadon
Hydrologin	Hydrologist
Sonnenhüter Tarim	Sunkeeper Tarim
Flammengeysir	Flame Geyser
Luftelementar	Air Elemental
Arkanologin	Arcanologist
Dampfwoger	Steam Surger
Illusionsbeschwörer	Mirage Caller
Manabindung	Mana Bind
Vulkan	Volcano
Pyros	Pyros
Öffnet das Portal	Open the Waygate
Schattenvisionen	Shadow Visions
Verbindende Heilung	Binding Heal
Kristallorakel	Crystalline Oracle
Strahlender Elementar	Radiant Elemental
Seltsame Leuchtwurzel	Curious Glimmerroot
Tortollanerpriesterin	Tortollan Shellraiser
Hungriger Pterrordax	Ravenous Pterrordax
Teerlauerer	Tar Lurker
Klingenblütensalve	Razorpetal Volley
Klingenblütenpeitscher	Razorpetal Lasher
Klonkapsel	Mimic Pod
Obsidiansplitter	Obsidian Shard
Fresswurz	Biteweed
Mörderorchidee	Vilespine Slayer
Sherazin die Aasblume	Sherazin, Corpse Flower
Abstieg in die Tiefe	The Caverns Below
Steinformer der Tol'vir	Tol'vir Stoneshaper
Riesenmastodon	Giant Mastodon
Steinhöhenverteidiger	Stonehill Defender
Steinteichjäger	Rockpool Hunter
Bösartiges Jungtier	Vicious Fledgling
Eierdieb	Eggnapper
Tortollanersammlerin	Tortollan Forager
Frostkoloss	Frozen Crusher
Donnerechse	Thunder Lizard
Teufelssaurierei	Devilsaur Egg
Feuersäulenphönix	Fire Plume Phoenix
Smaragdschwarmkönigin	Emerald Hive Queen
Riesenanakonda	Giant Anaconda
Bittertidenhydra	Bittertide Hydra
Tortollanerprimalistin	Tortollan Primalist
Gutmütiger Megasaurus	Gentle Megasaur
Geladener Teufelssaurier	Charged Devilsaur
Bewachsener Langhals	Verdant Longneck
Echsenwandler	Shellshifter
Mutierende Sporen	Evolving Spores
Irdene Schuppen	Earthen Scales
Urlanghals	Elder Longneck
Lebendiges Mana	Living Mana
Enthusiastische Späherin	Bright-Eyed Scout
Riesen des Urwalds	Jungle Giants
Totem der Urflossen	Primalfin Totem
Vorbote der Feuersäule	Fire Plume Harbinger
Gletschersplitter	Glacial Shard
Steinwächter	Stone Sentinel
Kalimos, Herr der Urzeit	Kalimos, Primal Lord
Schreckensschuppenjäger	Terrorscale Stalker
Nistender Roc	Nesting Roc
Smaragdhäscher	Emerald Reaver
Ultrasaurus	Ultrasaur
Golakkakrabbler	Golakka Crawler
Sture Urschnecke	Stubborn Gastropod
Feuerteufelchen	Fire Fly
Stegodon	Stegodon
Säbelzahnpirscher	Sabretooth Stalker
Sturmseher	Stormwatcher
Riesenwespe	Giant Wasp
Diener von Kalimos	Servant of Kalimos
Gezeitenwoge	Tidal Surge
Instabiler Elementar	Volatile Elemental
Waffe vergiften	Envenom Weapon
Opfer von Lakkari	Lakkari Sacrifice
Grausame Dinomantin	Cruel Dinomancer
Verderbender Nebel	Corrupting Mist
Blutblüte	Bloodbloom
Teufelshund von Lakkari	Lakkari Felhound
Fütterungszeit	Feeding Time
Zirpender Tunnelgräber	Chittering Tunneler
Gelegemutter Zavas	Clutchmother Zavas
Teerfürst	Tar Lord
Hemet der Dschungeljäger	Hemet, Jungle Hunter
Der Voraxx	The Voraxx
Kolossales Klingenblatt	Humongous Razorleaf
Vulkanelementar	Igneous Elemental
Flackernder Sturm	Shimmering Tempest
Glutbringer	Blazecaller
Urzeitlicher Drache	Primordial Drake
Elise die Entdeckerin	Elise the Trailblazer
Tyrantus	Tyrantus
In Bernstein gefangen	Free From Amber
Halluzination	Hallucination
Geistersängerin Umbra	Spiritsinger Umbra
Ozruk	Ozruk
Schrecklicher Biss	Grievous Bite
Juwelenara	Jeweled Macaw
Wächter der Tol'vir	Tol'vir Warden
Raptorjunges	Raptor Hatchling
Knisternder Scharfzahn	Crackling Razormaw
Stampede	Stampede
Dinomantie	Dinomancy
Sumpfkönig Dred	Swamp King Dred
Die Morastkönigin	The Marsh Queen
Erkundet Un'Goro	Explore Un'Goro
Eisenhaut	Iron Hide
Reizbares Terrorhorn	Ornery Direhorn
Umzingelte Wächterin	Cornered Sentry
Spontangenese	Sudden Genesis
Teerkriecher	Tar Creeper
Geschmolzene Klinge	Molten Blade
König Mosh	King Mosh
Das Herz der Feuersäule	Fire Plume's Heart
Späher der Urflossen	Primalfin Lookout
Thermalquellenwächter	Hot Spring Guardian
Erweckt die Schöpfer	Awaken the Makers
Glyphe der Urzeit	Primordial Glyph
Vereint die Murlocs	Unite the Murlocs
Gefräßiger Schlamm	Gluttonous Ooze
Geschmolzenes Ebenbild	Molten Reflection
Rankenrichter	Vinecleaver
Stachelbewehrtes Reittier	Spikeridged Steed
Krieger der Urflossen	Primalfin Champion
Der letzte Kaleidosaurier	The Last Kaleidosaur
Meteor	Meteor
Geisterecho	Spirit Echo
Terrorhornjunges	Direhorn Hatchling
Grüne Hölle	Lost in the Jungle
Mutation	Adaptation
Lichtgeladener Stegodon	Lightfused Stegodon
Lyra die Lichtbrecherin	Lyra the Sunshard
