Lance de flammes	Flame Lance
Effigie	Effigy
Héros défunt	Fallen Hero
Déflagration des Arcanes	Arcane Blast
Métamorphose : sanglier	Polymorph: Boar
Aspirant de Dalaran	Dalaran Aspirant
Jette-sorts	Spellslinger
Drake de Frimarra	Coldarra Drake
Rhonin	Rhonin
Dompteur de béliers	Ram Wrangler
Championne sacrée	Holy Champion
Rejeton des Ombres	Spawn of Shadows
Mot de pouvoir : Gloire	Power Word: Glory
Ombrefiel	Shadowfiend
Convertir	Convert
Confusion	Confuse
Gardien du Crépuscule	Twilight Guardian
Confesseur d’argent Paletress	Confessor Paletress
Destrier de l’effroi	Dreadsteed
Garde funeste effroyable	Fearsome Doomguard
Minuscule chevalier maléfique	Tiny Knight of Evil
Poing de Jaraxxus	Fist of Jaraxxus
Écraseur du Vide	Void Crusher
Fusion démoniaque	Demonfuse
Sombre marché	Dark Bargain
Garde-courroux	Wrathguard
Wilfred Flopboum	Wilfred Fizzlebang
Chevaucheur pandashan	Shado-Pan Rider
Boucanier	Buccaneer
Vaillant de Fossoyeuse	Undercity Valiant
Vide-gousset	Cutpurse
Marchand douteux	Shady Dealer
Larcin	Burgle
Lame empoisonnée	Poisoned Blade
Embusqué	Beneath the Grounds
Anub’arak	Anub'arak
Racines vivantes	Living Roots
Aspirante de Darnassus	Darnassus Aspirant
Combattant sauvage	Savage Combatant
Marcheuse sauvage	Wildwalker
Chevalier des étendues sauvages	Knight of the Wild
Druidesse du Sabre	Druid of the Saber
Communion astrale	Astral Communion
Charpie	Mulch
Aviana	Aviana
Rohart totémique	Tuskarr Totemic
Grave-totem draeneï	Draenei Totemcarver
Vague de soins	Healing Wave
Vaillant des Pitons-du-Tonnerre	Thunder Bluff Valiant
Marteau chargé	Charged Hammer
Destruction élémentaire	Elemental Destruction
Golem totémique	Totem Golem
Savoir ancestral	Ancestral Knowledge
Le mandebrume	The Mistcaller
Soins rapides	Flash Heal
Tir puissant	Powershot
Maître des écuries	Stablemaster
Elekk du roi	King's Elekk
Brave archère	Brave Archer
Piège à ours	Bear Trap
Prêt à tirer	Lock and Load
Boule d’araignées	Ball of Spiders
Gueule-d’acide	Acidmaw
Écaille-d’effroi	Dreadscale
Sonner	Bash
Défenseur du roi	King's Defender
Aspirant d’Orgrimmar	Orgrimmar Aspirant
Magnataure alpha	Magnataur Alpha
Renforcement	Bolster
Partenaire d’entraînement	Sparring Partner
Cap’taine céleste Kragg	Skycap'n Kragg
Championne d’Alexstrasza	Alexstrasza's Champion
Varian Wrynn	Varian Wrynn
Esprit combatif	Competitive Spirit
Sceau des champions	Seal of Champions
Maître des chevaux de guerre	Warhorse Trainer
Chevalier murloc	Murloc Knight
Lance d’Argent	Argent Lance
Entrée dans le Colisée	Enter the Coliseum
Adversaire mystérieux	Mysterious Challenger
Commandant du fief	Garrison Commander
Eadric le Pur	Eadric the Pure
Modeste écuyer	Lowly Squire
Chevaucheur de faucon-dragon	Dragonhawk Rider
Porte-lance	Lance Carrier
Damoiselle du Lac	Maiden of the Lake
Saboteur	Saboteur
Cavalier d’Argent	Argent Horserider
Champion de Mogor	Mogor's Champion
Lieutenant de la garde d’os	Boneguard Lieutenant
Champion de Mukla	Mukla's Champion
Médecin du tournoi	Tournament Medic
Enragé de glace	Ice Rager
Frigbold algide	Frigid Snobold
Jongleur de flammes	Flame Juggler
Chevalier silencieux	Silent Knight
Chevalier mécanique	Clockwork Knight
Spectateur du tournoi	Tournament Attendee
Mangesort prodigieuse	Sideshow Spelleater
Chevaucheuse de kodo	Kodorider
Régente de la Main d’argent	Silver Hand Regent
Combattante de la fosse	Pit Fighter
Jormungar capturé	Captured Jormungar
Kraken de la mer Boréale	North Sea Kraken
Jouteur rohart	Tuskarr Jouster
Kvaldir blessé	Injured Kvaldir
Champion de la Lumière	Light's Champion
Cheval de guerre cuirassé	Armored Warhorse
Guetteur d’Argent	Argent Watchman
Régisseur du Colisée	Coliseum Manager
Vendeur de rafraîchissements	Refreshment Vendor
Maître jouteur	Master Jouster
Recruteur	Recruiter
Provocateur maléfique	Evil Heckler
Maître d’escrime	Fencing Coach
Agent du Repos du ver	Wyrmrest Agent
Maîtresse de cérémonie	Master of Ceremonies
Grande croisée	Grand Crusader
Écumeur kvaldir	Kvaldir Raider
Géant du givre	Frost Giant
Favori de la foule	Crowd Favorite
Gormok l’Empaleur	Gormok the Impaler
Frissegueule	Chillmaw
Bolf Bélier-Frondeur	Bolf Ramshield
Glace-Hurlante	Icehowl
Champion du Nexus Saraad	Nexus-Champion Saraad
Le chevalier squelette	The Skeleton Knight
Fjola Plaie-lumineuse	Fjola Lightbane
Saccageur des mers	Sea Reaver
Eydis Plaie-sombre	Eydis Darkbane
Justicière Cœur-Vrai	Justicar Trueheart
Jouteuse de Gadgetzan	Gadgetzan Jouster
Veille solennelle	Solemn Vigil
Attise-flammes	Flamewaker
Souffle du dragon	Dragon's Breath
Dragonnet du Crépuscule	Twilight Whelp
Courroux démoniaque	Demonwrath
Chef du gang des diablotins	Imp Gang Boss
Recrutement	Gang Up
Furtif sombrefer	Dark Iron Skulker
Lourdaud volcanique	Volcanic Lumberer
Druidesse de la Flamme	Druid of the Flame
Horion de lave	Lava Shock
Destructeur garde du feu	Fireguard Destroyer
Tir réflexe	Quick Shot
Rageur du Magma	Core Rager
Revanche	Revenge
Lanceur de hache	Axe Flinger
Ressusciter	Resurrect
Dragon consort	Dragon Consort
Client sinistre	Grim Patron
Sorcier draconien	Dragonkin Sorcerer
Œuf de dragon	Dragon Egg
Écraseur drakônide	Drakonid Crusher
Drake volcanique	Volcanic Drake
Dragon affamé	Hungry Dragon
Chambellan Executus	Majordomo Executus
Empereur Thaurissan	Emperor Thaurissan
Rend Main-Noire	Rend Blackhand
Nefarian	Nefarian
Chromaggus	Chromaggus
Technicienne de l’Aile noire	Blackwing Technician
Corrupteur de l’Aile noire	Blackwing Corruptor
Raza l’Enchaîné	Raza the Chained
Potion de gel	Freezing Potion
Monte-en-l’air mécanique	Wind-up Burglebot
Cache d’armes	Hidden Cache
Entourloupeur des bas-fonds	Street Trickster
Wyrm de mana rouge	Red Mana Wyrm
Eauracle jinyu	Jinyu Waterspeaker
Protecteur des Dessoudeurs	Grimestreet Protector
Chimiste fou	Kooky Chemist
Baron Boule-de-Gras	Blubber Baron
Potion volcanique	Volcanic Potion
Laquais de la Kabale	Kabal Lackey
Soigneur hozen	Hozen Healer
Potion de gangrefeu	Felfire Potion
Fouine perce-tunnels	Weasel Tunneler
Maîtresse des mélanges	Mistress of Mixtures
Avocat commis d’office	Public Defender
Cavale de contrebandier	Smuggler's Run
Kun, le roi oublié	Kun the Forgotten King
Quatre murlocs et un enterrement	Call in the Finishers
Chef de jade	Jade Chieftain
Mon précieux	Finders Keepers
Chat de gouttière	Alleycat
Le clan des rats	Rat Pack
Informateur des bas-fonds	Grimestreet Informant
Regard de nacre	White Eyes
Boucanier de petite envergure	Small-Time Buccaneer
Organisatrice de combats	Fight Promoter
Phalanges	Knuckles
Caisse de contrebandier	Smuggler's Crate
Kodo de livraison	Dispatch Kodo
Porte-flingue secoué	Shaky Zipgunner
Lance-piranha	Piranha Launcher
Enrage-bête trogg	Trogg Beastrager
Sergent Sally	Sergeant Sally
Boucanier porte-grigris	Luckydo Buccaneer
Béhémoth de jade	Jade Behemoth
Bourbinja, l’étoile volante	Finja, the Flying Star
Idole de jade	Jade Idol
Potion de folie	Potion of Madness
Potion de soins supérieure	Greater Healing Potion
Agent drakônide	Drakonid Operative
Géode de mana	Mana Geode
Potion de cristal explosif	Blastcrystal Potion
Âmefiel gangr’orc	Fel Orc Soulfiend
Tisse-cristal	Crystalweaver
Potion rougefurie	Bloodfury Potion
Marque du Lotus	Mark of the Lotus
Puissance chapardée	Pilfered Power
Rêveuse céleste	Celestial Dreamer
Chimiste de la Kabale	Kabal Chemist
Potion de métamorphose	Potion of Polymorph
Kazakus	Kazakus
Projectiles des Arcanes majeurs	Greater Arcane Missiles
Prêtre de la serre de la Kabale	Kabal Talonpriest
Pièce contrefaite	Counterfeit Coin
Coup de poing en laiton	Brass Knuckles
Assassin du Lotus	Lotus Assassin
Enragé d’ombre	Shadow Rager
Neunœil le pirate	Patches the Pirate
Massacreur des Dessoudeurs	Grimestreet Enforcer
Hobart Martelutte	Hobart Grapplehammer
Lépreux occulte	Backstreet Leper
Sniper souffle-branchie	Blowgill Sniper
Racketteur de haut vol	Big-Time Racketeer
Messagère de la Kabale	Kabal Courier
Affranchi sinistrécaille	Grimscale Chum
Corsaire naga	Naga Corsair
Cogneur médiocre	Second-Rate Bruiser
Flingueur	Hired Gun
Barman amical	Friendly Bartender
Limon d’égout toxique	Toxic Sewer Ooze
Enquêteur perspicace	Streetwise Investigator
Vole-chant de la Kabale	Kabal Songstealer
Videur de l’arrière-salle	Backroom Bouncer
Mondaine de Gadgetzan	Gadgetzan Socialite
Incante-âme démente	Manic Soulcaster
Potion réductrice	Pint-Size Potion
Potion de feu draconique	Dragonfire Potion
Trafiquante de la Kabale	Kabal Trafficker
Motard worgen	Worgen Greaser
Maître de grouk-fu	Grook Fu Master
Experte en déminage	Bomb Squad
Gangsters, hé ho !	Doppelgangster
Caïd cambrioleur	Burgly Bully
Maire Brouillecaboche	Mayor Noggenfogger
Cryomancienne	Cryomancer
Madame Goya	Madam Goya
Don Han’Cho	Don Han'Cho
Maître des encres Solia	Inkmaster Solia
Motard huran	Spiked Hogrider
Shuriken de jade	Jade Shuriken
Grouillant de jade	Jade Swarmer
Passeur de Gadgetzan	Gadgetzan Ferryman
Sensei de l’ombre	Shadow Sensei
Dévolution	Devolve
Illusionniste du Lotus	Lotus Illusionist
Piqueur de démons des mers	Seadevil Stinger
Éclair de jade	Jade Lightning
Floraison de jade	Jade Blossom
Esprit de jade	Jade Spirit
Nourrir les poissons	Sleep with the Fishes
Griffes de jade	Jade Claws
Krul le Déchaîné	Krul the Unshackled
Massacreur abyssal	Abyssal Enforcer
Marchandises volées	Stolen Goods
Outilleur des Dessoudeurs	Grimestreet Outfitter
Gadgétiseur des Dessoudeurs	Grimy Gadgeteer
Usurière des Dessoudeurs	Grimestreet Pawnbroker
Armurière clandestine	Alley Armorsmith
Marshal malhonnête	Meanstreet Marshal
Livre-cristaux de la Kabale	Kabal Crystal Runner
Shaku, le Collectionneur	Shaku, the Collector
Rat déloyal	Dirty Rat
Kodo de cavale	Getaway Kodo
Irion	Wrathion
Commissaire-priseur Beardo	Auctionmaster Beardo
Genzo, le Requin	Genzo, the Shark
Chopper huran de Tanaris	Tanaris Hogchopper
Chef hurane vêtue de cuir	Leatherclad Hogleader
Visions lunaires	Lunar Visions
Barbefeu Tresse-Flammes	Wickerflame Burnbristle
Sensei virmen	Virmen Sensei
Journaliste intrépide	Daring Reporter
Agents du Lotus	Lotus Agents
Contrebandière des bas-fonds	Grimestreet Smuggler
Ancien des floraisons	Ancient of Blossoms
Nettoyeur défias	Defias Cleaner
Apothicaire clandestin	Unlicensed Apothecary
Aya Patte Noire	Aya Blackpaw
Recrues à la petite semaine	Small-Time Recruits
Je connais un gars	I Know a Guy
Soldat de Comté-de-l’Or	Goldshire Footman
Rampant des tourbières	Fen Creeper
Nova sacrée	Holy Nova
Contrôle mental	Mind Control
Feu intérieur	Inner Fire
Châtiment sacré	Holy Smite
Vision télépathique	Mind Vision
Mot de pouvoir : Bouclier	Power Word: Shield
Griffe	Claw
Toucher guérisseur	Healing Touch
Éclat lunaire	Moonfire
Marque du fauve	Mark of the Wild
Rugissement sauvage	Savage Roar
Balayage	Swipe
Croissance sauvage	Wild Growth
Métamorphose	Polymorph
Intelligence des Arcanes	Arcane Intellect
Éclair de givre	Frostbolt
Explosion des Arcanes	Arcane Explosion
Nova de givre	Frost Nova
Image miroir	Mirror Image
Blizzard	Blizzard
Boule de feu	Fireball
Javelot de glace	Ice Lance
Choc de flammes	Flamestrike
Élémentaire d’eau	Water Elemental
Horion de givre	Frost Shock
Esprit ancestral	Ancestral Spirit
Furie des vents	Windfury
Guérison ancestrale	Ancestral Healing
Élémentaire de feu	Fire Elemental
Arme croque-roc	Rockbiter Weapon
Furie sanguinaire	Bloodlust
Double vue	Far Sight
Trait de l’ombre	Shadow Bolt
Diablotin de sang	Blood Imp
Drain de vie	Drain Life
Flammes infernales	Hellfire
Corruption	Corruption
Infernal de l’effroi	Dread Infernal
Marcheur du Vide	Voidwalker
Attaque sournoise	Backstab
Sang froid	Cold Blood
Poison mortel	Deadly Poison
Attaque pernicieuse	Sinister Strike
Assassiner	Assassinate
Sprint	Sprint
Lame d’assassin	Assassin's Blade
Marque du chasseur	Hunter's Mark
Bénédiction de puissance	Blessing of Might
Gardien des rois	Guardian of Kings
Lumière sacrée	Holy Light
Justice de la Lumière	Light's Justice
Bénédiction des rois	Blessing of Kings
Consécration	Consecration
Marteau de courroux	Hammer of Wrath
Championne en vrai-argent	Truesilver Champion
Charge	Charge
Saccager	Rampage
Frappe héroïque	Heroic Strike
Hache de guerre embrasée	Fiery War Axe
Exécution	Execute
Faucheuse en arcanite	Arcanite Reaper
Enchaînement	Cleave
Prophète du Cercle terrestre	Earthen Ring Farseer
Enragé du magma	Magma Rager
Gueule d’acier des oasis	Oasis Snapjaw
Crocilisque des rivières	River Crocolisk
Grunt loup-de-givre	Frostwolf Grunt
Chef de raid	Raid Leader
Chevaucheur de loup	Wolfrider
Grizzly Ferpoil	Ironfur Grizzly
Patriarche dos-argenté	Silverback Patriarch
Chevalier de Hurlevent	Stormwind Knight
Fusilier de Forgefer	Ironforge Rifleman
Géomancien kobold	Kobold Geomancer
Matelot des mers du Sud	Southsea Deckhand
Inventrice gnome	Gnomish Inventor
Commando foudrepique	Stormpike Commando
Champion de la Main d’argent	Silver Hand Knight
Archimage	Archmage
Assassin de Ravenholdt	Ravenholdt Assassin
Seigneur de l’arène	Lord of the Arena
Écumeur murloc	Murloc Raider
Jeune faucon-dragon	Young Dragonhawk
Sanglier brocheroc	Stonetusk Boar
Raptor Rougefange	Bloodfen Raptor
Guerrier branchie-bleue	Bluegill Warrior
Maître-bouclier de Sen’jin	Sen'jin Shieldmasta
Maître-lame blessé	Injured Blademaster
Yéti noroît	Chillwind Yeti
Golem de guerre	War Golem
Garde de Baie-du-Butin	Booty Bay Bodyguard
Sergent grossier	Abusive Sergeant
Archère elfe	Elven Archer
Chasseuse de Tranchebauge	Razorfen Hunter
Ogre-magi	Ogre Magi
Ogre rochepoing	Boulderfist Ogre
Chien du Magma	Core Hound
Chouette bec-de-fer	Ironbeak Owl
Missilière téméraire	Reckless Rocketeer
Forgeron malveillant	Spiteful Smith
Champion de Hurlevent	Stormwind Champion
Chef de guerre loup-de-givre	Frostwolf Warlord
Nervi de la KapitalRisk	Venture Co. Mercenary
Feu follet	Wisp
Protecteur Écorcefer	Ironbark Protector
Déluge de lames	Blade Flurry
Mot de l’ombre : Douleur	Shadow Word: Pain
Clerc de Comté-du-Nord	Northshire Cleric
Esprit divin	Divine Spirit
Busard affamé	Starving Buzzard
Soigneuse sombrécaille	Darkscale Healer
Maître-chien	Houndmaster
Loup des bois	Timber Wolf
Rhino de la toundra	Tundra Rhino
Flèches multiples	Multi-Shot
Pistage	Tracking
Tir des Arcanes	Arcane Shot
Arc long du gladiateur	Gladiator's Longbow
Attaque mentale	Mind Blast
Gardelumière	Lightwarden
Le Chevalier noir	The Black Knight
Jeune prêtresse	Young Priestess
Chasseur de gros gibier	Big Game Hunter
Robot d’alarme	Alarm-o-Bot
Acolyte de la souffrance	Acolyte of Pain
Écuyère d’Argent	Argent Squire
Poulet furieux	Angry Chicken
Infiltrateur worgen	Worgen Infiltrator
Docteur vaudou	Voodoo Doctor
Mage de sang Thalnos	Bloodmage Thalnos
Roi Mukla	King Mukla
Ingénieur novice	Novice Engineer
Sylvanas Coursevent	Sylvanas Windrunner
Panthère de la jungle	Jungle Panther
Clerc du Soleil brisé	Shattered Sun Cleric
Croisée écarlate	Scarlet Crusader
Long-voyant de Thrallmar	Thrallmar Farseer
Garde de Lune-d’argent	Silvermoon Guardian
Mécano de petit dragon	Dragonling Mechanic
Tigre de Strangleronce	Stranglethorn Tiger
Gnome lépreux	Leper Gnome
Marche-soleil	Sunwalker
Harpie Furie-des-vents	Windfury Harpy
Drake du Crépuscule	Twilight Drake
Aventurier en pleine quête	Questing Adventurer
Guetteur ancien	Ancient Watcher
Nain sombrefer	Dark Iron Dwarf
Brise-sort	Spellbreaker
Jeune maître brasseur	Youthful Brewmaster
Oracle froide-lumière	Coldlight Oracle
Accro au mana	Mana Addict
Ancien maître brasseur	Ancient Brewmaster
Protectrice solfurie	Sunfury Protector
Alchimiste dément	Crazed Alchemist
Vieux Troublœil	Old Murk-Eye
Limon des marais acide	Acidic Swamp Ooze
Commandant d’Argent	Argent Commander
Minuscule invocatrice	Pint-Sized Summoner
Gardienne des secrets	Secretkeeper
Bombardier fou	Mad Bomber
Suprétincelle	Tinkmaster Overspark
Officier chanteguerre	Warsong Commander
Contrôleur mental	Mind Control Tech
Golem arcanique	Arcane Golem
Prêtresse de la Cabale	Cabal Shadow Priest
Défenseur d’Argus	Defender of Argus
Commissaire-priseur	Gadgetzan Auctioneer
Amasseur de butin	Loot Hoarder
Abomination	Abomination
Chroniqueur Cho	Lorewalker Cho
Démolisseur	Demolisher
Voyant froide-lumière	Coldlight Seer
Géant des montagnes	Mountain Giant
Cairne Sabot-de-Sang	Cairne Bloodhoof
Gelbin Mekkanivelle	Gelbin Mekkatorque
Leeroy Jenkins	Leeroy Jenkins
Éviscération	Eviscerate
Trahison	Betrayal
Dissimuler	Conceal
Éventail de couteaux	Fan of Knives
Noble sacrifice	Noble Sacrifice
Meneur défias	Defias Ringleader
Œil pour œil	Eye for an Eye
Lame de la perdition	Perdition's Blade
Agent du SI:7	SI:7 Agent
Rédemption	Redemption
Casse-tête	Headcrack
Pas de l’ombre	Shadowstep
Préparation	Preparation
Colère	Wrath
Marque de la nature	Mark of Nature
Âme de la forêt	Soul of the Forest
Puissance du fauve	Power of the Wild
Acclimatation	Naturalize
Loup alpha redoutable	Dire Wolf Alpha
Nourrir	Nourish
Druide de la Griffe	Druid of the Claw
Gardien du bosquet	Keeper of the Grove
Innervation	Innervate
Cobra empereur	Emperor Cobra
Feu stellaire	Starfire
Ancien de la guerre	Ancient of War
Éclair	Lightning Bolt
Explosion de lave	Lava Burst
Diable de poussière	Dust Devil
Puissance totémique	Totemic Might
Horion de terre	Earth Shock
Maléfice	Hex
Hache de Forge-foudre	Stormforged Axe
Esprit farouche	Feral Spirit
Baron Geddon	Baron Geddon
Élémentaire de terre	Earth Elemental
Fourche d’éclairs	Forked Lightning
Élémentaire délié	Unbound Elemental
Tempête de foudre	Lightning Storm
Arcaniste éthérien	Ethereal Arcanist
Cône de froid	Cone of Cold
Projectiles des Arcanes	Arcane Missiles
Kriss	Shiv
Explosion pyrotechnique	Pyroblast
Élémentaire de givre	Frost Elemental
Drake azur	Azure Drake
Contresort	Counterspell
Barrière de glace	Ice Barrier
Entité miroir	Mirror Entity
Bloc de glace	Ice Block
Ragnaros, seigneur du feu	Ragnaros the Firelord
Gangregarde	Felguard
Voile de mort	Mortal Coil
Ombreflamme	Shadowflame
Terreur du Vide	Void Terror
Succube	Succubus
Feu de l’âme	Soulfire
Siphonner l’âme	Siphon Soul
Garde funeste	Doomguard
Néant distordu	Twisting Nether
Seigneur des abîmes	Pit Lord
Portail d’invocation	Summoning Portal
Puissance accablante	Power Overwhelming
Détection des démons	Sense Demons
Diablotin des flammes	Flame Imp
Plaie funeste	Bane of Doom
Seigneur Jaraxxus	Lord Jaraxxus
Silence	Silence
Folie de l’ombre	Shadow Madness
Rejeton de lumière	Lightspawn
Vol d’esprit	Thoughtsteal
Puits de lumière	Lightwell
Jeux d’esprit	Mindgames
Faveur divine	Divine Favor
Prophète Velen	Prophet Velen
Imposition des mains	Lay on Hands
Bénédiction du champion	Blessed Champion
Humilité	Humility
Protecteur d’Argent	Argent Protector
Bénédiction de sagesse	Blessing of Wisdom
Colère divine	Holy Wrath
Épée de justice	Sword of Justice
Main de protection	Hand of Protection
Repentir	Repentance
Garde-paix de l’Aldor	Aldor Peacekeeper
Tirion Fordring	Tirion Fordring
Courroux vengeur	Avenging Wrath
Guerrier tauren	Tauren Warrior
Heurtoir	Slam
Rage du combat	Battle Rage
Berserker amani	Amani Berserker
Gardien mogu’shan	Mogu'shan Warden
Fabricante d’armes	Arathi Weaponsmith
Berserker gurubashi	Gurubashi Berserker
Tourbillon	Whirlwind
Fabricante d’armures	Armorsmith
Porte-bouclier	Shieldbearer
Baston	Brawl
Frappe mortelle	Mortal Strike
Amélioration !	Upgrade!
Heurt de bouclier	Shield Slam
Hurlesang	Gorehowl
Worgen déchaîné	Raging Worgen
Grommash Hurlenfer	Grommash Hellscream
Chasse-marée murloc	Murloc Tidehunter
Chef de guerre murloc	Murloc Warleader
Oracle sinistrécaille	Grimscale Oracle
Mande-flots murloc	Murloc Tidecaller
Assassin patient	Patient Assassin
Hyène charognarde	Scavenging Hyena
Détournement	Misdirection
Grande crinière des savanes	Savannah Highmane
Arc cornedaigle	Eaglehorn Bow
Tir explosif	Explosive Shot
Lâcher les chiens	Unleash the Hounds
Ordre de tuer	Kill Command
Roi Krush	King Krush
Fusée éclairante	Flare
Courroux bestial	Bestial Wrath
Piège à serpents	Snake Trap
Golem des moissons	Harvest Golem
Nat Pagle	Nat Pagle
Harrison Jones	Harrison Jones
Archimage Antonidas	Archmage Antonidas
Nozdormu	Nozdormu
Alexstrasza	Alexstrasza
Onyxia	Onyxia
Malygos	Malygos
Manipulateur sans-visage	Faceless Manipulator
Totem Langue de feu	Flametongue Totem
Marteau-du-Destin	Doomhammer
Morsure	Bite
Force de la nature	Force of Nature
Ysera	Ysera
Cénarius	Cenarius
Totem de vague de mana	Mana Tide Totem
La Bête	The Beast
Sauvagerie	Savagery
Assommer	Sap
Mage de Dalaran	Dalaran Mage
Prêtresse d’Élune	Priestess of Elune
Mage ancien	Ancient Mage
Géant des mers	Sea Giant
Parlevent	Windspeaker
Chevalier de sang	Blood Knight
Prêtresse auchenaï	Auchenai Soulpriest
Lamenuit	Nightblade
Vaporisation	Vaporize
Maître de culte	Cult Master
Feu démoniaque	Demonfire
Maître des diablotins	Imp Master
Sous-chef cruel	Cruel Taskmaster
Berserker écumant	Frothing Berserker
Maîtrise du blocage	Shield Block
Rage intérieure	Inner Rage
Apprentie du sorcier	Sorcerer's Apprentice
Tir de précision	Snipe
Piège explosif	Explosive Trap
Piège givrant	Freezing Trap
Mage du Kirin Tor	Kirin Tor Mage
Edwin VanCleef	Edwin VanCleef
Illidan Hurlorage	Illidan Stormrage
Âme en peine de mana	Mana Wraith
Tir meurtrier	Deadly Shot
Égalité	Equality
Géant de lave	Molten Giant
Cercle de soins	Circle of Healing
Mot de l’ombre : Mort	Shadow Word: Death
Massacreur du temple	Temple Enforcer
Flammes sacrées	Holy Fire
Forme d’Ombre	Shadowform
Dissipation de masse	Mass Dispel
Croq’zombie	Zombie Chow
Rampante hantée	Haunted Creeper
Limon résonnant	Echoing Ooze
Savant fou	Mad Scientist
Ombre de Naxxramas	Shade of Naxxramas
Œuf de nérubien	Nerubian Egg
Chevalier spectral	Spectral Knight
Seigneur de la mort	Deathlord
Maexxna	Maexxna
Tisseuse	Webspinner
Crache-vase	Sludge Belcher
Kel’Thuzad	Kel'Thuzad
Stalagg	Stalagg
Feugen	Feugen
Âme gémissante	Wailing Soul
Seigneur de la toile nérub’ar	Nerub'ar Weblord
Dupliquer	Duplicate
Graines de poison	Poison Seeds
Venger	Avenge
Morsure de la mort	Death's Bite
Implorateur du Vide	Voidcaller
Sombre sectateur	Dark Cultist
Goule instable	Unstable Ghoul
Réincarnation	Reincarnate
Embusqué anub’ar	Anub'ar Ambusher
Gargouille peau-de-pierre	Stoneskin Gargoyle
Fossoyeur	Undertaker
Épées dansantes	Dancing Swords
Horreb	Loatheb
Baron Vaillefendre	Baron Rivendare
Canon lance-flammes	Flamecannon
Souffle-neige	Snowchugger
Portail instable	Unstable Portal
Explomage gobelin	Goblin Blastmage
Écho de Medivh	Echo of Medivh
Méca-téléporteur	Mechwarper
Léviathan des flammes	Flame Leviathan
Bombe de lumière	Lightbomb
Bombardière d’ombre	Shadowbomber
Choix de Velen	Velen's Chosen
Réducteur fou	Shrinkmeister
Lumière des naaru	Light of the Naaru
Maître des rouages	Cogmaster
Vol’jin	Vol'jin
Bombe de matière noire	Darkbomb
Saccageur gangrené	Fel Reaver
Appel du familier	Call Pet
Maîtresse de Douleur	Mistress of Pain
Cœur de démon	Demonheart
Gangrecanon	Fel Cannon
Mal’Ganis	Mal'Ganis
Huile d’affûtage de Bricoleur	Tinker's Sharpsword Oil
Robot barbier gobelin	Goblin Auto-Barber
Clé de maître des rouages	Cogmaster's Wrench
Tricheur borgne	One-eyed Cheat
Feindre la mort	Feign Death
Sensei de fer	Iron Sensei
Prince marchand Gallywix	Trade Prince Gallywix
Appel des ancêtres	Ancestor's Call
Ourson robot anodisé	Anodized Robo Cub
Recyclage	Recycle
Sylvenier du Bosquet	Grove Tender
Arbre de vie	Tree of Life
Méca chat-ours	Mech-Bear-Cat
Malorne	Malorne
Masse de puissance	Powermace
Zap-o-matic tournoyant	Whirling Zap-o-matic
Crépitement	Crackle
Totem de vitalité	Vitality Totem
Marche-esprit aileron vaseux	Siltfin Spiritwalker
Sombres feux follets	Dark Wispers
Neptulon	Neptulon
Glaivezooka	Glaivezooka
Char araignée	Spider Tank
Éruption de diablotins	Imp-losion
Roi des bêtes	King of Beasts
Sabotage	Sabotage
Bondisseur dent-de-métal	Metaltooth Leaper
Gahz’rilla	Gahz'rilla
Lame rebondissante	Bouncing Blade
Robo-baston	Warbot
Écraser	Crush
Vierge guerrière	Shieldmaiden
Cogneguerre ogre	Ogre Warmaul
Cliquetteur perce-vrille	Screwjank Clunker
Mastodonte de fer	Iron Juggernaut
Sceau de Lumière	Seal of Light
Mini-robot blindé	Shielded Minibot
Rouage-marteau	Coghammer
Intendant	Quartermaster
Régiment de bataille	Muster for Battle
Gardien de cobalt	Cobalt Guardian
Bolvar Fordragon	Bolvar Fordragon
Saute-flaque	Puddlestomper
Brute ogre	Ogre Brute
Chaman cognedune	Dunemaul Shaman
Trogg brisepierre	Stonesplinter Trogg
Trogg mâcheroc mastoc	Burly Rockjaw Trogg
Robot de soins antique	Antique Healbot
Mataf	Salty Dog
Haut-trotteur égaré	Lost Tallstrider
Boxeur de l’ombre	Shadowboxer
Tir du cobra	Cobra Shot
Mystique de Kezan	Kezan Mystic
Canon du navire	Ship's Cannon
Mouton explosif	Explosive Sheep
Golem d’anima	Anima Golem
Yéti mécanique	Mechanical Yeti
Char de force MAX	Force-Tank MAX
Druide du Croc	Druid of the Fang
Traqueur gloubelin	Gilblin Stalker
Gnome mécanique	Clockwork Gnome
Robot réparateur amélioré	Upgraded Repair Bot
Machine volante	Flying Machine
Ennuy-o-tron	Annoy-o-Tron
Engin de siège	Siege Engine
Sniper de Gentepression	Steamwheedle Sniper
Ninja ogre	Ogre Ninja
Illuminatrice	Illuminator
Bombardier cinglé	Madder Bomber
Annulateur d’Arcane X-21	Arcane Nullifier X-21
Expérimentateur gnome	Gnomish Experimenter
Cible leurre	Target Dummy
Jeeves	Jeeves
Sapeur gobelin	Goblin Sapper
Déchiqueteur piloté	Piloted Shredder
Mini exorciste	Lil' Exorcist
Infanterie de Gnomeregan	Gnomeregan Infantry
Lobe-Bombe	Bomb Lobber
Guetteur flottant	Floating Watcher
Purificateur écarlate	Scarlet Purifier
Technicien de Brikabrok	Tinkertown Technician
Micro-machine	Micro Machine
Hobgobelin	Hobgoblin
Golem céleste piloté	Piloted Sky Golem
Brik-à-bot	Junkbot
Mécano-amplificateur	Enhance-o Mechano
Recombobulateur	Recombobulator
Mini-mage	Mini-Mage
Dr Boum	Dr. Boom
Tête de Mimiron	Mimiron's Head
Mogor l’ogre	Mogor the Ogre
Faucheur 4000	Foe Reaper 4000
Vieux déchiqueteur de Sneed	Sneed's Old Shredder
Toshley	Toshley
Mekgénieur Thermojoncteur	Mekgineer Thermaplugg
Gazleu	Gazlowe
Troggzor le Terreminator	Troggzor the Earthinator
Bling-o-tron 3000	Blingtron 3000
Hemet Nesingwary	Hemet Nesingwary
Géant mécanique	Clockwork Giant
Mini stoppe-sort	Wee Spellstopper
Cracheur de suie	Soot Spewer
Garrosh Hurlenfer	Garrosh Hellscream
Magni Barbe-de-Bronze	Magni Bronzebeard
Thrall	Thrall
Morgl l’Oracle	Morgl the Oracle
Valeera Sanguinar	Valeera Sanguinar
Maiev Chantelombre	Maiev Shadowsong
Uther le Porteur de Lumière	Uther Lightbringer
Dame Liadrin	Lady Liadrin
Prince Arthas	Prince Arthas
Rexxar	Rexxar
Alleria Coursevent	Alleria Windrunner
Malfurion Hurlorage	Malfurion Stormrage
Gul’dan	Gul'dan
Nemsie Nécroflop	Nemsy Necrofizzle
Jaina Portvaillant	Jaina Proudmoore
Medivh	Medivh
Khadgar	Khadgar
Anduin Wrynn	Anduin Wrynn
Tyrande Murmevent	Tyrande Whisperwind
Flibustière fantôme	Phantom Freebooter
Squelettomancien	Skelemancer
Déflagroptère boursouflé	Exploding Bloatbat
Pingouin glisseneige	Snowflipper Penguin
Vaurien cliquetant	Rattling Rascal
Nécromancienne sinistre	Grim Necromancer
Drake d’os	Bone Drake
Val’kyr solnée	Sunborne Val'kyr
Plaiedécaille cobalt	Cobalt Scalebane
Hurleur nocturne	Night Howler
Venimancien	Venomancer
Croisé arrogant	Arrogant Crusader
Protectrice vertueuse	Righteous Protector
Sombre conviction	Dark Conviction
Profanation	Defile
Tisse-destin	Fatespinner
Flèche toxique	Toxic Arrow
Tisse-toile	Webweave
Druidesse de l’essaim	Druid of the Swarm
Fais le mort	Play Dead
Plaie envahissante	Spreading Plague
Drain d’âme	Drain Soul
Cryostase	Cryostasis
Brrrloc	Brrrloc
Armure piton-de-feu	Mountainfire Armor
Lame de sang	Blood Razor
Baron des os	Bone Baron
Vrygoule	Vryghoul
Marche-glace	Ice Walker
Adjuratrice spectrale	Ghastly Conjurer
Deuil de la Lumière	Light's Sorrow
Seigneur de l’effroi abject	Despicable Dreadlord
Avalanche	Avalanche
Grognement	Gnash
Défenseur drakkari	Drakkari Defender
Clone de glace	Frozen Clone
Apprentie damnée	Doomed Apprentice
Fléau ultime	Ultimate Infestation
Mystères glacés	Glacial Mysteries
Maléficieuse vaudou	Voodoo Hexxer
Pêche sur glace	Ice Fishing
Géant fureur-des-neiges	Snowfury Giant
Main du mort	Dead Man's Hand
Vétéran d’Acherus	Acherus Veteran
Pêcheur rohart	Tuskarr Fisherman
Clerc du Soleil déchu	Fallen Sun Cleric
Colosse de la fournaise	Furnacefire Colossus
Fléau des tombes	Grave Shambler
Rôdeur des tombes	Tomb Lurker
Abomination tic-taquante	Ticking Abomination
Piège frappe-venin	Venomstrike Trap
Jet d’osselets	Roll the Bones
Professeur Putricide	Professor Putricide
Traîtrise	Treachery
Dévoration mentale	Devour Mind
Ascendante de l’ombre	Shadow Ascendant
Acolyte de l’agonie	Acolyte of Agony
Servitude éternelle	Eternal Servitude
Statue d’obsidienne	Obsidian Statue
Archevêque Benedictus	Archbishop Benedictus
Démon hurleur	Howlfiend
Chevalier mortécaille	Deadscale Knight
Poison sangsue	Leeching Poison
Boomerang damné	Doomerang
Essence d’ombre	Shadow Essence
Brise-glace	Ice Breaker
Berserker animé	Animated Berserker
Hanteur de la runeforge	Runeforge Haunter
Veuve nécrophage	Corpse Widow
Résistance désespérée	Desperate Stand
Garde noir	Blackguard
Âmefroide	Coldwraith
Résurrecteur	Corpse Raiser
Forge des Âmes	Forge of Souls
Moorabi	Moorabi
Le roi-liche	The Lich King
Trognepus	Rotface
Gnomeferatu	Gnomeferatu
Brigue-âme val’kyr	Val'kyr Soulclaimer
Pisteur recousu	Stitched Tracker
Ours-requin	Bearshark
Revenant d’outre-tombe	Death Revenant
Enchaînés de saronite	Saronite Chain Gang
Nécroratrice	Deathspeaker
Laboureur maudit	Wretched Tiller
Sacrifice nécessaire	Unwilling Sacrifice
Thrall le mort-voyant	Thrall, Deathseer
Goule joyeuse	Happy Ghoul
Geist rôdeur	Skulking Geist
Fossoyeuse futile	Shallow Gravedigger
Palefroi d’os	Bonemare
Détrameur nérubien	Nerubian Unraveler
Commandant hurlant	Howling Commander
Fouet spirituel	Spirit Lash
Pillard dure-écaille	Strongshell Scavenger
Seigneur des cryptes	Crypt Lord
Scientifique de la peste	Plague Scientist
Punisseur hachemort	Deathaxe Punisher
Lilian Voss	Lilian Voss
Chariot à viande	Meat Wagon
Champion frisselame	Chillblade Champion
Simulacre	Simulacrum
Archer abominable	Abominable Bowman
Valeera l’Exsangue	Valeera the Hollow
Rexxar le nécrotraqueur	Deathstalker Rexxar
Uther de la Lame d’ébène	Uther of the Ebon Blade
Anduin le faucheur noir	Shadowreaper Anduin
Gul’dan le saccage-sang	Bloodreaver Gul'dan
Malfurion le Putride	Malfurion the Pestilent
Jaina liche de givre	Frost Lich Jaina
Garrosh seigneur du Fléau	Scourgelord Garrosh
Hadronox	Hadronox
Souffle de Sindragosa	Breath of Sindragosa
Venez vous battre !	Bring It On!
Sindragosa	Sindragosa
Reine de sang Lana’thel	Blood-Queen Lana'thel
Étreinte ténébreuse	Embrace Darkness
Lame-de-l’ombre	Shadowblade
Prince Keleseth	Prince Keleseth
Prince Taldaram	Prince Taldaram
Prince Valanar	Prince Valanar
Arfus	Arfus
Coursegivre hyldnir	Hyldnir Frostrider
Tisse-sort	Spellweaver
Bolvar sang-de-feu	Bolvar, Fireblood
Geist nécrotique	Necrotic Geist
Enchanteresse drakkari	Drakkari Enchanter
Brise-esprit	Mindbreaker
Fêtard sanguin	Sanguine Reveler
Squelette malfaisant	Wicked Skeleton
Ver de sang	Bloodworm
Pilleuse spectrale	Spectral Pillager
Banshee plaintive	Keening Banshee
Capte-talents	Corpsetaker
Zélote impure	Tainted Zealot
Surprise du chef	Cat Trick
Gentille grand-mère	Kindly Grandmother
Chasseresse capuchonnée	Cloaked Huntress
Grimoire bavard	Babbling Book
Templier Plaie-de-nuit	Nightbane Templar
Comédien pompeux	Pompous Thespian
Purification	Purify
Méchante sorcière	Wicked Witchdoctor
Kara Kazham !	Kara Kazham!
Protégez le roi !	Protect the King!
Écrase-patate	Fool's Bane
Œuf runique	Runic Egg
Araignée du garde-manger	Pantry Spider
Wyrm de bibliothèque	Book Wyrm
Prêtre du festin	Priest of the Feast
Anomalie arcanique	Arcane Anomaly
Gardien aviaire	Avian Watcher
Rôdeur des douves	Moat Lurker
Moroes	Moroes
Cavalier en ivoire	Ivory Knight
Le conservateur	The Curator
Biographe de Dédain-du-Néant	Netherspite Historian
Griffes spectrales	Spirit Claws
Gardienne de la Ménagerie	Menagerie Warden
Fieffé forban	Swashburglar
Colporteur éthérien	Ethereal Peddler
Portail du Maelström	Maelstrom Portal
Portail de Reflet-de-Lune	Moonglade Portal
Portail des terres de Feu	Firelands Portal
Portail de Lune-d’Argent	Silvermoon Portal
Diablotin de Malchezaar	Malchezaar's Imp
Portail de Forgefer	Ironforge Portal
Valet de Medivh	Medivh's Valet
Fourchette mortelle	Deadly Fork
Zoobot	Zoobot
Prince Malchezaar	Prince Malchezaar
Medivh, le Gardien	Medivh, the Guardian
Barnes	Barnes
Fou en onyx	Onyx Bishop
Golem d’argenterie	Silverware Golem
Corbeau enchanté	Enchanted Raven
Magicien de la Ménagerie	Menagerie Magician
Forge-Arcanes	Arcanosmith
Géant arcanique	Arcane Giant
Illusionniste pourpre	Violet Illusionist
Torche oubliée	Forgotten Torch
Adjurateur éthérien	Ethereal Conjurer
Conservateur du musée	Museum Curator
Malédiction de Rafaam	Curse of Rafaam
Destructeur d’obsidienne	Obsidian Destroyer
Serpent de la fosse	Pit Snake
Reno Jackson	Reno Jackson
Pilleur de tombes	Tomb Pillager
Élémentaire grondant	Rumbling Elemental
Gardienne d’Uldaman	Keeper of Uldaman
Trogg des tunnels	Tunnel Trogg
Raptor déterré	Unearthed Raptor
Dromadaire du désert	Desert Camel
Piège de fléchettes	Dart Trap
Singe féroce	Fierce Monkey
Sinistre colporteur	Dark Peddler
Tous les murlocs de ta vie	Anyfin Can Happen
Épreuve sacrée	Sacred Trial
Scarabée orné de joyaux	Jeweled Scarab
Sorcière des mers naga	Naga Sea Witch
Gorillobot A-3	Gorillabot A-3
Crapaud énorme	Huge Toad
Araignée des tombes	Tomb Spider
Raptor de monte	Mounted Raptor
Sélénien de la jungle	Jungle Moonkin
Djinn des zéphirs	Djinni of Zephyrs
Sentinelle Anubisath	Anubisath Sentinel
Diablosaure fossilisé	Fossilized Devilsaur
Sir Finley Mrrgglton	Sir Finley Mrrgglton
Brann Barbe-de-Bronze	Brann Bronzebeard
Élise Cherchétoile	Elise Starseeker
Pierre d’invocation	Summoning Stone
Avortons tremblants	Wobbling Runts
Prince voleur Rafaam	Arch-Thief Rafaam
Ensevelir	Entomb
Chapeau d’explorateur	Explorer's Hat
Statue sinistre	Eerie Statue
Ombre ancienne	Ancient Shade
Mal déterré	Excavated Evil
Tout est vraiment génial	Everyfin is Awesome
Idole corbeau	Raven Idol
Chercheuse du Reliquaire	Reliquary Seeker
Lame maudite	Cursed Blade
Armure animée	Animated Armor
Murloc mini-aileron	Murloc Tinyfin
Cri psychique	Psychic Scream
Homoncule sans-gêne	Vulgar Homunculus
Kobold de bibliothèque	Kobold Librarian
Sombre pacte	Dark Pact
Saccageur sadique	Hooked Reaver
Marcheuse fal’dorei	Fal'dorei Strider
Trouve-qui-brille	Cavern Shinyfinder
Barbare kobold	Kobold Barbarian
Améthyste de sort inférieure	Lesser Amethyst Spellstone
Gantelet à lame	Bladed Gauntlet
Écorce	Barkskin
Golem en bois de fer	Ironwood Golem
Jaspe de sort inférieur	Lesser Jasper Spellstone
Embranchement	Branching Paths
Tigre astral	Astral Tiger
Main écrasante	Crushing Hand
Ermite kobold	Kobold Hermit
Saphir de sort inférieur	Lesser Sapphire Spellstone
Rôdeur des égouts	Sewer Crawler
Frappe latérale	Flanking Strike
Hydre des cavernes	Cave Hydra
Monstre errant	Wandering Monster
Émeraude de sort inférieure	Lesser Emerald Spellstone
Rhok’delar	Rhok'delar
Potion d’héroïsme	Potion of Heroism
Perle de sort inférieure	Lesser Pearl Spellstone
Appel aux armes	Call to Arms
Runes explosives	Explosive Runes
Rubis de sort inférieur	Lesser Ruby Spellstone
Parchemin changeant	Shifting Scroll
Deck miraculeux	Deck of Wonders
Aluneth	Aluneth
Scorpiomatic	Scorp-o-matic
Élémentaire de cire	Wax Elemental
Forgeron d’ébène	Ebon Dragonsmith
Vase corrosive	Corrosive Sludge
Champion solitaire	Lone Champion
Basilic peau de pierre	Stoneskin Basilisk
Tyran des Arcanes	Arcane Tyrant
Gelée verte	Green Jelly
Tueuse de dragons	Dragonslayer
Coffre carnassier	Toothy Chest
Diable sournois	Sneaky Devil
Dragon assoupi	Sleepy Dragon
Dragon au trésor	Hoarding Dragon
Ver tunnelier	Corridor Creeper
Moussorceleur furbolg	Furbolg Mossbinder
Barde inspirée	Boisterous Bard
Ver géant violet	Violet Wurm
Cavalier Mufle-de-gravier	Gravelsnout Knight
Cube carnivore	Carnivorous Cube
Sonya Danselombre	Sonya Shadowdancer
Fongimancien	Fungalmancer
Familier corbeau	Raven Familiar
Fureur du dragon	Dragon's Fury
Avant-garde d’argent	Silver Vanguard
Appel du crépuscule	Twilight's Call
Coursier chatoyant	Shimmering Courser
Mithril de sort inférieur	Lesser Mithril Spellstone
Trompe-la-mort	Cheat Death
Âme de dragon	Dragon Soul
Trahison soudaine	Sudden Betrayal
Ménestrel elfe	Elven Minstrel
Évasion	Evasion
Lynessa Tristesoleil	Lynessa Sunsorrow
À mes côtés	To My Side!
Bafouilleur farouche	Feral Gibberer
Cire-à-l’arc	Candleshot
Artificier des Arcanes	Arcane Artificer
Disciple maudit	Cursed Disciple
Taupe sinistre	Dire Mole
Élixir non identifié	Unidentified Elixir
Bouclier non identifié	Unidentified Shield
Maillet non identifié	Unidentified Maul
Brasse-champi	Shroom Brewer
Laquais possédé	Possessed Lackey
Appel du chêne	Oaken Summons
Lion de cristal	Crystal Lion
Gardien griffu	Grizzled Guardian
Trogg gobe-gloups	Trogg Gloomeater
Seigneur fongique Ixlid	Ixlid, Fungal Lord
Gain de niveau !	Level Up!
Talismans primordiaux	Primal Talismans
Apprenti kobold	Kobold Apprentice
Lutin cupide	Greedy Sprite
Sonde psionique	Psionic Probe
Marin le malandrin	Marin the Fox
Gravats le ruine-monde	Grumble, Worldshaker
Geôlier acariâtre	Drygulch Jailor
Déluge de coups	Reckless Flurry
Golem serti de gemmes	Gemstudded Golem
Armurier sèche-moustache	Drywhisker Armorer
Seigneur du Vide	Voidlord
Regroupement	Gather Your Party
Pluie guérisseuse	Healing Rain
Recruteuse de la guilde	Guild Recruiter
Tranche-malheur	Woecleaver
Moine kobold	Kobold Monk
Ettin affamé	Hungry Ettin
Enchanteur mycélien	Fungal Enchanter
Kobold farfouilleur	Rummaging Kobold
Brindille de l’Arbre-Monde	Twig of the World Tree
Chantepignon	Shrieking Shroom
Djinn bienveillant	Benevolent Djinn
Brise-pénombre	Duskbreaker
Illusionniste kobold	Kobold Illusionist
Scarabée cuirassé	Plated Beetle
Grand archiviste	Grand Archivist
Rin la première disciple	Rin, the First Disciple
Cataclysme	Cataclysm
Crâne du Man’ari	Skull of the Man'ari
Val’anyr	Val'anyr
Onyx de sort inférieur	Lesser Onyx Spellstone
Évolution instable	Unstable Evolution
La Sorcelance	The Runespear
Diamant de sort inférieur	Lesser Diamond Spellstone
Kathrena Fétu-d’Hiver	Kathrena Winterwisp
Zola la gorgone	Zola the Gorgon
Élémentaire murmurant	Murmuring Elemental
Mande-foudre des Vents	Windshear Stormcaller
Géosculpteur Yip	Geosculptor Yip
Suinteux suintant	Seeping Oozeling
Maître Chênecœur	Master Oakheart
Murs broyeurs	Crushing Walls
Les ténèbres	The Darkness
Acolyte du Crépuscule	Twilight Acolyte
Déchireur du Vide	Void Ripper
Gargouille dorée	Gilded Gargoyle
Mande-dragon Alanna	Dragoncaller Alanna
Manipulateur tellurique	Leyline Manipulator
Temporus	Temporus
Invocatrice malveillante	Spiteful Summoner
Couve-dragon	Dragonhatcher
Roi Cire-Pilleur	King Togwaggle
Plaie des rois	Kingsbane
Pacte sacrificiel	Sacrificial Pact
Disparition	Vanish
Kidnappeur	Kidnapper
Météores	Starfall
Ancien du savoir	Ancient of Lore
Al’Akir, seigneur des Vents	Al'Akir the Windlord
Soldat d’élite kor’kron	Kor'kron Elite
Wyrm de mana	Mana Wyrm
Maîtresse du déguisement	Master of Disguise
Perroquet du capitaine	Captain's Parrot
Crabe affamé	Hungry Crab
Mousse de la Voile sanglante	Bloodsail Raider
Jongleur de couteaux	Knife Juggler
Pyromancien sauvage	Wild Pyromancer
Auspice funeste	Doomsayer
Corsaire de l’effroi	Dread Corsair
Dragon féerique	Faerie Dragon
Capitaine Vertepeau	Captain Greenskin
Forban de la Voile sanglante	Bloodsail Corsair
Enseignante pourpre	Violet Teacher
Capitaine des mers du Sud	Southsea Captain
Millhouse Tempête-de-Mana	Millhouse Manastorm
Aile de mort	Deathwing
Compagnon animal	Animal Companion
Cri de commandement	Commanding Shout
Maître fabricant d’épées	Master Swordsmith
Gruul	Gruul
Lardeur	Hogger
Kodo déchaîné	Stampeding Kodo
Inquisiteur Aileron noir	Vilefin Inquisitor
Fusion primordiale	Primal Fusion
Sans-visage nimbé de flammes	Flamewreathed Faceless
Sentinelle éternelle	Eternal Sentinel
Évolution	Evolve
Chose venue d’en bas	Thing from Below
Marteau du crépuscule	Hammer of Twilight
Tentacules brachiaux	Tentacles for Arms
Grouillant silithide	Silithid Swarmer
Y’Shaarj, la rage déchaînée	Y'Shaarj, Rage Unbound
Fandral Forteramure	Fandral Staghelm
Infester	Infest
Rage farouche	Feral Rage
Marque d’Y’Shaarj	Mark of Y'Shaarj
Ancien frappé d’interdit	Forbidden Ancient
En chasse	On the Hunt
Sectateur de la Lame	Bladed Cultist
Périple dans les abîmes	Journey Below
Thé de chardon	Thistle Tea
Xaril l’Esprit empoisonné	Xaril, Poisoned Mind
Fracasser	Shatter
Kobold évolué	Evolved Kobold
Mande-flamme du Crépuscule	Twilight Flamecaller
Mande-givre dément	Demented Frostcaller
Flamme interdite	Forbidden Flame
Serviteur de Yogg-Saron	Servant of Yogg-Saron
Grimoire de cabaliste	Cabalist's Tome
Mot de pouvoir : Tentacules	Power Word: Tentacles
Soigneuse du Crépuscule	Twilight Darkmender
Mot de l’ombre : Horreur	Shadow Word: Horror
Mutation interdite	Forbidden Shaping
Sombre orateur	Darkspeaker
Étreindre l’ombre	Embrace the Shadow
Archiviste de Sombre-Comté	Darkshire Librarian
Conseiller de Sombre-Comté	Darkshire Councilman
Rituel interdit	Forbidden Ritual
Folie galopante	Spreading Madness
Parjurer les ténèbres	Renounce Darkness
Anomalus	Anomalus
Cho’gall	Cho'gall
Mukla, tyran du val	Mukla, Tyrant of the Vale
Déphaseur Zerus	Shifter Zerus
Empereur jumeau Vek’lor	Twin Emperor Vek'lor
N’Zoth le corrupteur	N'Zoth, the Corruptor
Yogg-Saron, la fin de l’espoir	Yogg-Saron, Hope's End
Prophète nérubien	Nerubian Prophet
Béhémoth sans-visage	Faceless Behemoth
Horreur indicible	Eldritch Horror
Psych-o-tron	Psych-o-Tron
Robot de soins corrompu	Corrupted Healbot
Goule ravageuse	Ravaging Ghoul
Berserker aberrant	Aberrant Berserker
Tentacule de N’Zoth	Tentacle of N'Zoth
Faucon-dragon difforme	Grotesque Dragonhawk
Rampant des marais	Bog Creeper
Murloc aileron-bilieux	Bilefin Tidehunter
Initié zélé	Zealous Initiate
Voyant corrompu	Corrupted Seer
Disciple de C’Thun	Disciple of C'Thun
Sang de l’Ancien	Blood of The Ancient One
Traînard sans-visage	Faceless Shambler
Attaque d’ombre	Shadow Strike
Chauve-souris embrasée	Fiery Bat
Tisse-ambre klaxxi	Klaxxi Amber-Weaver
Feux follets funestes	Wisps of the Old Gods
Guérison interdite	Forbidden Healing
Auspice funeste confirmé	Validated Doomsayer
Gardien du bourbier	Mire Keeper
Coup de tonnerre	Stormcrack
Invocateur sans-visage	Faceless Summoner
Hallazèle l’Élevé	Hallazeal the Ascended
Appel de la nature	Call of the Wild
Loup contaminé	Infested Wolf
Brave Sabot-de-Sang	Bloodhoof Brave
Malkorok	Malkorok
Héroïne altruiste	Selfless Hero
Lame de ralliement	Rallying Blade
Force divine	Divine Strength
Ragnaros, porteur de Lumière	Ragnaros, Lightlord
Alchimiste de Sombre-Comté	Darkshire Alchemist
MALÉDICTION !	DOOM!
Villageois possédé	Possessed Villager
Worgen corrompu	Twisted Worgen
Enragé am’gam	Am'gam Rager
Tauren contaminé	Infested Tauren
Mange-secrets	Eater of Secrets
Implorateur funeste	Doomcaller
Rejeton de N’Zoth	Spawn of N'Zoth
Face de poulpe	Southsea Squidface
Cauchemar écailleux	Scaled Nightmare
Invocateur du Crépuscule	Twilight Summoner
Résister aux ténèbres	Stand Against Darkness
Guerriers de sang	Blood Warriors
C’Thun	C'Thun
Annonciatrice du mal	Beckoner of Evil
Lame de C’Thun	Blade of C'Thun
Élue de C’Thun	C'Thun's Chosen
Géomancienne du Crépuscule	Twilight Geomancer
Ancien du Crépuscule	Twilight Elder
Ancien héraut	Ancient Harbinger
Exhalombre	Shadowcaster
Traqueur lugubre	Forlorn Stalker
Sombre arakkoa	Dark Arakkoa
Apothicaire du culte	Cult Apothecary
L’Épouvantueur	The Boogeymonster
Ancienne porte-bouclier	Ancient Shieldbearer
Passeuse d’âmes	Usher of Souls
Ensorceleuse du culte	Cult Sorcerer
Ver des sables géant	Giant Sand Worm
Princesse Huhuran	Princess Huhuran
Régisseuse de Sombre-Comté	Steward of Darkshire
Lumière dans les ténèbres	A Light in the Darkness
Second de N’Zoth	N'Zoth's First Mate
Grizzly perturbé	Addled Grizzly
Du sang à l’ichor	Blood To Ichor
Adepte de la Voile sanglante	Bloodsail Cultist
Héraut Volazj	Herald Volazj
Seigneur Aile de mort	Deathwing, Dragonlord
Lardeur, Perte d’Elwynn	Hogger, Doom of Elwynn
Drake de minuit	Midnight Drake
Adorateur fanatisé	Crazed Worshipper
Pirate des flots noirs	Blackwater Pirate
Amasseur vicié	Polluted Hoarder
Larve putride	Carrion Grub
Sanglier de pénombre	Duskboar
Tentacule remuant	Squirming Tentacle
Maître de l’évolution	Master of Evolution
Colporteur de Fossoyeuse	Undercity Huckster
Acolyte capuchonnée	Hooded Acolyte
Ombre mouvante	Shifting Shade
Horreur cyclopéenne	Cyclopian Horror
Nat le sombre pêcheur	Nat, the Darkfisher
Sectateur Skeram	Skeram Cultist
Soggoth le Rampant	Soggoth the Slitherer
Elite Tauren Chieftain	Elite Tauren Chieftain
Goule mangeuse de chair	Flesheating Ghoul
Courbe-sort	Spellbender
Jeune pterreurdactyle	Pterrordax Hatchling
Volcanosaure	Volcanosaur
Gigantosaure	Dinosize
Ravasaure chétif	Ravasaur Runt
Battrodon rassasié	Sated Threshadon
Hydrologue	Hydrologist
Garde-soleil Tarim	Sunkeeper Tarim
Geyser de flammes	Flame Geyser
Élémentaire d’air	Air Elemental
Arcanologue	Arcanologist
Surgisseur de vapeur	Steam Surger
Mande-mirage	Mirage Caller
Liens de mana	Mana Bind
Volcan	Volcano
Pyros	Pyros
Ouverture du portail	Open the Waygate
Visions de l’Ombre	Shadow Visions
Soins de lien	Binding Heal
Oracle cristallin	Crystalline Oracle
Élémentaire radieux	Radiant Elemental
Racinéclat curieux	Curious Glimmerroot
Lève-carapace tortollan	Tortollan Shellraiser
Pterreurdactyle vorace	Ravenous Pterrordax
Rôdeur du goudron	Tar Lurker
Salve de tranche-pétales	Razorpetal Volley
Flagellant tranche-pétale	Razorpetal Lasher
Cosse caméléon	Mimic Pod
Éclat d’obsidienne	Obsidian Shard
Herbosaurus	Biteweed
Vilépine tueuse	Vilespine Slayer
Shérazine, fleur putrescente	Sherazin, Corpse Flower
Grotte des profondeurs	The Caverns Below
Sculpte-pierre tol’vir	Tol'vir Stoneshaper
Mastodonte géant	Giant Mastodon
Défenseur de Butte-Pierre	Stonehill Defender
Chasseur rochecave	Rockpool Hunter
Pterreurdactyle vicieux	Vicious Fledgling
Œuf-nappeur	Eggnapper
Fourrageur tortollan	Tortollan Forager
Écraseur gelé	Frozen Crusher
Lézard-tonnerre	Thunder Lizard
Œuf de diablosaure	Devilsaur Egg
Phénix de la Fournaise	Fire Plume Phoenix
Reine émeraude	Emerald Hive Queen
Anaconda géant	Giant Anaconda
Hydre flot-amer	Bittertide Hydra
Primaliste tortollan	Tortollan Primalist
Gentil mégasaure	Gentle Megasaur
Diablosaure chargé	Charged Devilsaur
Brachiosaure verdoyant	Verdant Longneck
Change-carapace	Shellshifter
Spores évolutives	Evolving Spores
Écailles terrestres	Earthen Scales
Ancien brachiosaure	Elder Longneck
Mana vivant	Living Mana
Éclaireur enthousiaste	Bright-Eyed Scout
Géants de la jungle	Jungle Giants
Totem primaileron	Primalfin Totem
Messager de la Fournaise	Fire Plume Harbinger
Éclat glaciaire	Glacial Shard
Sentinelle de pierre	Stone Sentinel
Seigneur Kalimos	Kalimos, Primal Lord
Traqueur écaille-de-terreur	Terrorscale Stalker
Roc nicheur	Nesting Roc
Saccageur émeraude	Emerald Reaver
Ultrasaure	Ultrasaur
Clampant de Golakka	Golakka Crawler
Gastéropode têtu	Stubborn Gastropod
Flammetin	Fire Fly
Stégosaure	Stegodon
Traqueur dent de sabre	Sabretooth Stalker
Guette-tempête	Stormwatcher
Guêpe géante	Giant Wasp
Serviteur de Kalimos	Servant of Kalimos
Vague de marée	Tidal Surge
Élémentaire volatil	Volatile Elemental
Arme toxique	Envenom Weapon
Sacrifice lakkari	Lakkari Sacrifice
Dinomancien cruel	Cruel Dinomancer
Brume corruptrice	Corrupting Mist
Fleur de sang	Bloodbloom
Gangrechien lakkari	Lakkari Felhound
L’heure du repas	Feeding Time
Tunnelier cliquetant	Chittering Tunneler
Matriarche Zavas	Clutchmother Zavas
Seigneur du goudron	Tar Lord
Hemet de la jungle	Hemet, Jungle Hunter
Le Voraxx	The Voraxx
Tranchefeuille monstrueux	Humongous Razorleaf
Élémentaire igné	Igneous Elemental
Tempête chatoyante	Shimmering Tempest
Mande-brasier	Blazecaller
Drake primordial	Primordial Drake
Élise la Pionnière	Elise the Trailblazer
Tyrantus	Tyrantus
Libéré de l’ambre	Free From Amber
Hallucination	Hallucination
Chante-esprit Umbra	Spiritsinger Umbra
Ozruk	Ozruk
Grave morsure	Grievous Bite
Ara orné de joyaux	Jeweled Macaw
Gardien tol’vir	Tol'vir Warden
Jeune raptor	Raptor Hatchling
Tranchegueule crépitant	Crackling Razormaw
Ruée	Stampede
Dinomancie	Dinomancy
Roi du marais Dred	Swamp King Dred
La reine du marécage	The Marsh Queen
Exploration d’Un’Goro	Explore Un'Goro
Peau de fer	Iron Hide
Navrecorne hargneux	Ornery Direhorn
Factionnaire acculée	Cornered Sentry
Genèse soudaine	Sudden Genesis
Rampeur du goudron	Tar Creeper
Lame magmatique	Molten Blade
Roi Mosh	King Mosh
Cœur de la Fournaise	Fire Plume's Heart
Guetteur primaileron	Primalfin Lookout
Gardien des sources	Hot Spring Guardian
Réveil des Faiseurs	Awaken the Makers
Glyphe primordial	Primordial Glyph
Les murlocs font la force	Unite the Murlocs
Limon glouton	Gluttonous Ooze
Reflet de magma	Molten Reflection
Tranche-lianes	Vinecleaver
Destrier à pointes	Spikeridged Steed
Champion primaileron	Primalfin Champion
Le dernier kaléïdosaure	The Last Kaleidosaur
Météore	Meteor
Écho spirituel	Spirit Echo
Jeune navrecorne	Direhorn Hatchling
Perdus dans la jungle	Lost in the Jungle
Adaptabilité	Adaptation
Stégosaure magmafeu	Lightfused Stegodon
Lyra, l’éclat du soleil	Lyra the Sunshard
