Огненное копье	Flame Lance
Чучело	Effigy
Павший герой	Fallen Hero
Чародейская вспышка	Arcane Blast
Превращение в вепря	Polymorph: Boar
Боец из Даларана	Dalaran Aspirant
Чаромет	Spellslinger
Дракон Хладарры	Coldarra Drake
Ронин	Rhonin
Пастух	Ram Wrangler
Святая защитница	Holy Champion
Исчадие теней	Spawn of Shadows
Слово силы: Слава	Power Word: Glory
Исчадие Тьмы	Shadowfiend
Обращение	Convert
Замешательство	Confuse
Сумеречный страж	Twilight Guardian
Исповедница Пейлтресс	Confessor Paletress
Конь погибели	Dreadsteed
Грозный демон	Fearsome Doomguard
Малый рыцарь зла	Tiny Knight of Evil
Кулак Джараксуса	Fist of Jaraxxus
Крушитель из Бездны	Void Crusher
Демоническая сила	Demonfuse
Темная сделка	Dark Bargain
Страж гнева	Wrathguard
Вилфред Непопамс	Wilfred Fizzlebang
Всадник Шадо-Пан	Shado-Pan Rider
Буканьер	Buccaneer
Рыцарь Подгорода	Undercity Valiant
Карманник	Cutpurse
Сомнительный делец	Shady Dealer
Воришка	Burgle
Отравленное лезвие	Poisoned Blade
Из-под земли	Beneath the Grounds
Ануб'арак	Anub'arak
Живые корни	Living Roots
Боец из Дарнаса	Darnassus Aspirant
Яростный воин	Savage Combatant
Дикая странница	Wildwalker
Рыцарь чащи	Knight of the Wild
Друид-саблезуб	Druid of the Saber
Астральное единение	Astral Communion
Мульчирование	Mulch
Авиана	Aviana
Клыкарр-шаман	Tuskarr Totemic
Резчица тотемов	Draenei Totemcarver
Волна исцеления	Healing Wave
Рыцарь Громового Утеса	Thunder Bluff Valiant
Магический молот	Charged Hammer
Разрушительные стихии	Elemental Destruction
Тотемный голем	Totem Golem
Древнее знание	Ancestral Knowledge
Призыватель туманов	The Mistcaller
Быстрое исцеление	Flash Heal
Мощный выстрел	Powershot
Главный конюх	Stablemaster
Королевский элекк	King's Elekk
Храбрая лучница	Brave Archer
Медвежья ловушка	Bear Trap
На изготовку!	Lock and Load
Паучий клубок	Ball of Spiders
Кислотная Утроба	Acidmaw
Жуткая Чешуя	Dreadscale
Оглушить	Bash
Королевский поборник	King's Defender
Боец из Оргриммара	Orgrimmar Aspirant
Вожак магнатавров	Magnataur Alpha
Усиление	Bolster
Спарринг-партнер	Sparring Partner
Крагг Поднебесный	Skycap'n Kragg
Защитница Алекстразы	Alexstrasza's Champion
Вариан Ринн	Varian Wrynn
Боевой настрой	Competitive Spirit
Печать чемпионов	Seal of Champions
Боевой берейтор	Warhorse Trainer
Мурлок-рыцарь	Murloc Knight
Серебряное копье	Argent Lance
Вход в Колизей	Enter the Coliseum
Загадочный претендент	Mysterious Challenger
Командир гарнизона	Garrison Commander
Эдрик Чистый	Eadric the Pure
Скромный оруженосец	Lowly Squire
Всадник на дракондоре	Dragonhawk Rider
Копьеносец	Lance Carrier
Озерная дева	Maiden of the Lake
Саботажник	Saboteur
Серебряный всадник	Argent Horserider
Защитник Могора	Mogor's Champion
Костяной лейтенант	Boneguard Lieutenant
Защитник Муклы	Mukla's Champion
Лекарь турнира	Tournament Medic
Ледяной яростень	Ice Rager
Морозный снобольд	Frigid Snobold
Жонглер пламенем	Flame Juggler
Молчаливый рыцарь	Silent Knight
Заводной рыцарь	Clockwork Knight
Зритель турнира	Tournament Attendee
Глотательница чар	Sideshow Spelleater
Всадница на кодо	Kodorider
Паладин-регент	Silver Hand Regent
Боец арены	Pit Fighter
Пленный йормунгар	Captured Jormungar
Кракен Северного моря	North Sea Kraken
Бретер-клыкарр	Tuskarr Jouster
Раненый квалдир	Injured Kvaldir
Защитник Света	Light's Champion
Бронированный скакун	Armored Warhorse
Серебряный дозорный	Argent Watchman
Распорядитель Колизея	Coliseum Manager
Продавец закусок	Refreshment Vendor
Великий бретер	Master Jouster
Вербовщик	Recruiter
Злобный насмешник	Evil Heckler
Учитель фехтования	Fencing Coach
Драконий посланник	Wyrmrest Agent
Церемониймейстер	Master of Ceremonies
Великий рыцарь	Grand Crusader
Квалдир-налетчик	Kvaldir Raider
Ледяной великан	Frost Giant
Кумир толпы	Crowd Favorite
Гормок	Gormok the Impaler
Ледяная Пасть	Chillmaw
Болф Таранный Щит	Bolf Ramshield
Ледяной Рев	Icehowl
Сараад, рыцарь Нексуса	Nexus-Champion Saraad
Рыцарь-скелет	The Skeleton Knight
Фьола Погибель Света	Fjola Lightbane
Гроза морей	Sea Reaver
Эйдис Погибель Тьмы	Eydis Darkbane
Мариэль Чистосердечная	Justicar Trueheart
Бретер из Прибамбасска	Gadgetzan Jouster
Священное бдение	Solemn Vigil
Поджигатель	Flamewaker
Дыхание дракона	Dragon's Breath
Сумеречный дракончик	Twilight Whelp
Демонический гнев	Demonwrath
Главарь банды бесов	Imp Gang Boss
Сходка	Gang Up
Тихоступ Черного Железа	Dark Iron Skulker
Вулканический древень	Volcanic Lumberer
Друид пламени	Druid of the Flame
Лавовый шок	Lava Shock
Огнестраж-разрушитель	Fireguard Destroyer
Скорострельность	Quick Shot
Яростень Недр	Core Rager
Возмездие	Revenge
Метатель топоров	Axe Flinger
Воскрешение	Resurrect
Супруга дракона	Dragon Consort
Мрачный завсегдатай	Grim Patron
Драконор-чародей	Dragonkin Sorcerer
Яйцо дракона	Dragon Egg
Драконид-сокрушитель	Drakonid Crusher
Вулканический дракон	Volcanic Drake
Голодный дракон	Hungry Dragon
Мажордом Экзекутус	Majordomo Executus
Император Тауриссан	Emperor Thaurissan
Ренд Чернорук	Rend Blackhand
Нефариан	Nefarian
Хромаггус	Chromaggus
Техник Крыла Тьмы	Blackwing Technician
Губитель Крыла Тьмы	Blackwing Corruptor
Раза Плененный	Raza the Chained
Зелье заморозки	Freezing Potion
Заводной воробот	Wind-up Burglebot
Схрон	Hidden Cache
Уличный фокусник	Street Trickster
Алый маназмей	Red Mana Wyrm
Говорящий с водой	Jinyu Waterspeaker
Защитник трущоб	Grimestreet Protector
Чокнутый химик	Kooky Chemist
Толстосум	Blubber Baron
Вулканическое зелье	Volcanic Potion
Прихвостень «Кабала»	Kabal Lackey
Хозен-лекарь	Hozen Healer
Зелье огня Скверны	Felfire Potion
Пронырливая ласка	Weasel Tunneler
Мастерица микстур	Mistress of Mixtures
Адвокат	Public Defender
Незаконный ввоз	Smuggler's Run
Кун, Забытый Король	Kun the Forgotten King
Мурлоковороты	Call in the Finishers
Нефритовый вождь	Jade Chieftain
Было ваше, стало наше!	Finders Keepers
Бродячий кот	Alleycat
Крысиная стая	Rat Pack
Осведомитель из трущоб	Grimestreet Informant
Млечноокий	White Eyes
Мелкий буканьер	Small-Time Buccaneer
Организатор боев	Fight Promoter
Кулакс	Knuckles
Контрабандный товар	Smuggler's Crate
Патрульный кодо	Dispatch Kodo
Самопальщик	Shaky Zipgunner
Пиранострел	Piranha Launcher
Трогг-погонщик	Trogg Beastrager
Сержант Салли	Sergeant Sally
Удачливый буканьер	Luckydo Buccaneer
Нефритовое чудище	Jade Behemoth
Мурлиндзя	Finja, the Flying Star
Нефритовый идол	Jade Idol
Зелье безумия	Potion of Madness
Среднее лечебное зелье	Greater Healing Potion
Драконид-шпион	Drakonid Operative
Мановая жеода	Mana Geode
Зелье взрыв-кристалла	Blastcrystal Potion
Душегуб Скверны	Fel Orc Soulfiend
Заклинатель кристаллов	Crystalweaver
Зелье кровавой ярости	Bloodfury Potion
Знак «Лотоса»	Mark of the Lotus
Кража силы	Pilfered Power
Небесная провидица	Celestial Dreamer
Химик «Кабала»	Kabal Chemist
Зелье превращения	Potion of Polymorph
Казакус	Kazakus
Чародейские суперстрелы	Greater Arcane Missiles
Жрец Когтя из «Кабала»	Kabal Talonpriest
Фальшивая монетка	Counterfeit Coin
Латунный кастет	Brass Knuckles
Убийца из «Лотоса»	Lotus Assassin
Яростень Тьмы	Shadow Rager
Пират Глазастик	Patches the Pirate
Громила из трущоб	Grimestreet Enforcer
Хобарт Дрек	Hobart Grapplehammer
Лепрогном из подворотни	Backstreet Leper
Снайпер Свистожабрых	Blowgill Sniper
Матерый гангстер	Big-Time Racketeer
Курьер «Кабала»	Kabal Courier
Живец Темной Чешуи	Grimscale Chum
Нага-корсар	Naga Corsair
Второсортный костолом	Second-Rate Bruiser
Наемник	Hired Gun
Радушный трактирщик	Friendly Bartender
Токсичный слизнюк	Toxic Sewer Ooze
Уличный детектив	Streetwise Investigator
Песнекрад «Кабала»	Kabal Songstealer
Вышибала	Backroom Bouncer
Светская львица	Gadgetzan Socialite
Заклинательница душ	Manic Soulcaster
Гномозелье	Pint-Size Potion
Зелье драконьего огня	Dragonfire Potion
Перевозчица «Кабала»	Kabal Trafficker
Ворген-стиляга	Worgen Greaser
Мастер грук-фу	Grook Fu Master
Подрывница	Bomb Squad
Доппельгангстер	Doppelgangster
Вороватый задира	Burgly Bully
Мэр Гогельмогель	Mayor Noggenfogger
Криомантка	Cryomancer
Мадам Гойя	Madam Goya
Дон Хан'Чо	Don Han'Cho
Каллиграф Солия	Inkmaster Solia
Шипастый хряк	Spiked Hogrider
Нефритовый сюрикэн	Jade Shuriken
Нефритовый роевик	Jade Swarmer
Паромщик	Gadgetzan Ferryman
Сенсей Тьмы	Shadow Sensei
Инволюция	Devolve
Иллюзионистка «Лотоса»	Lotus Illusionist
Морской дьявол	Seadevil Stinger
Нефритовая молния	Jade Lightning
Нефритовый цветок	Jade Blossom
Нефритовый дух	Jade Spirit
На корм рыбам	Sleep with the Fishes
Нефритовые когти	Jade Claws
Крул Освобожденный	Krul the Unshackled
Могучий абиссал	Abyssal Enforcer
Чужое добро	Stolen Goods
Торговец из трущоб	Grimestreet Outfitter
«Бугай»-технарь	Grimy Gadgeteer
Ростовщица из трущоб	Grimestreet Pawnbroker
Уличная бронница	Alley Armorsmith
Страж порядка	Meanstreet Marshal
Разносчица кристаллов	Kabal Crystal Runner
Шаку Собиратель	Shaku, the Collector
Грязная крыса	Dirty Rat
Побег на кодо	Getaway Kodo
Гневион	Wrathion
Аукционист Вихлюн	Auctionmaster Beardo
Шулер Гензо	Genzo, the Shark
Турбохряк из Танариса	Tanaris Hogchopper
Главарь «Ночных хряков»	Leatherclad Hogleader
Лунные видения	Lunar Visions
Сенопал Огнеус	Wickerflame Burnbristle
Гну-синь-сенсей	Virmen Sensei
Бесстрашный репортер	Daring Reporter
Агенты «Лотоса»	Lotus Agents
Контрабандистка	Grimestreet Smuggler
Древо цветения	Ancient of Blossoms
Ликвидатор из Братства	Defias Cleaner
Подпольный аптекарь	Unlicensed Apothecary
Айя Черная Лапа	Aya Blackpaw
Мелкие сошки	Small-Time Recruits
Я знаю кое-кого	I Know a Guy
Солдат Златоземья	Goldshire Footman
Трясинный ползун	Fen Creeper
Кольцо света	Holy Nova
Контроль разума	Mind Control
Внутренний огонь	Inner Fire
Божественная кара	Holy Smite
Внутреннее зрение	Mind Vision
Слово силы: Щит	Power Word: Shield
Коготь	Claw
Целебное касание	Healing Touch
Лунный огонь	Moonfire
Знак дикой природы	Mark of the Wild
Дикий рев	Savage Roar
Размах	Swipe
Буйный рост	Wild Growth
Превращение	Polymorph
Интеллект чародея	Arcane Intellect
Ледяная стрела	Frostbolt
Чародейский взрыв	Arcane Explosion
Кольцо льда	Frost Nova
Зеркальные копии	Mirror Image
Снежная буря	Blizzard
Огненный шар	Fireball
Ледяное копье	Ice Lance
Волна огня	Flamestrike
Элементаль воды	Water Elemental
Ледяной шок	Frost Shock
Дух предков	Ancestral Spirit
Неистовство ветра	Windfury
Исцеление предков	Ancestral Healing
Элементаль огня	Fire Elemental
Камнедробитель	Rockbiter Weapon
Жажда крови	Bloodlust
Дальнее зрение	Far Sight
Стрела Тьмы	Shadow Bolt
Кровавый бес	Blood Imp
Похищение жизни	Drain Life
Адское пламя	Hellfire
Порча	Corruption
Жуткий инфернал	Dread Infernal
Демон Бездны	Voidwalker
Удар в спину	Backstab
Хладнокровие	Cold Blood
Смертоносный яд	Deadly Poison
Коварный удар	Sinister Strike
Ликвидация	Assassinate
Спринт	Sprint
Клинок убийцы	Assassin's Blade
Метка охотника	Hunter's Mark
Печать могущества	Blessing of Might
Защитник королей	Guardian of Kings
Свет небес	Holy Light
Правосудие Света	Light's Justice
Печать королей	Blessing of Kings
Освящение	Consecration
Молот гнева	Hammer of Wrath
Серебряный клинок	Truesilver Champion
Рывок	Charge
Буйство	Rampage
Удар героя	Heroic Strike
Огненная секира	Fiery War Axe
Казнь	Execute
Арканитовый жнец	Arcanite Reaper
Рассекающий удар	Cleave
Служитель Земли	Earthen Ring Farseer
Магмовый яростень	Magma Rager
Оазисный хрустогрыз	Oasis Snapjaw
Речной кроколиск	River Crocolisk
Боец Северного Волка	Frostwolf Grunt
Лидер рейда	Raid Leader
Всадник на волке	Wolfrider
Гризли-сталемех	Ironfur Grizzly
Седоспин-патриарх	Silverback Patriarch
Рыцарь Штормграда	Stormwind Knight
Ружейник Стальгорна	Ironforge Rifleman
Кобольд-геомант	Kobold Geomancer
Матрос Южных морей	Southsea Deckhand
Гном-изобретатель	Gnomish Inventor
Дворф-диверсант	Stormpike Commando
Рыцарь Длани	Silver Hand Knight
Верховный маг	Archmage
Скрытный убийца	Ravenholdt Assassin
Повелитель арены	Lord of the Arena
Мурлок-налетчик	Murloc Raider
Молодой дракондор	Young Dragonhawk
Вепрь-камнеклык	Stonetusk Boar
Ящер Кровавой Топи	Bloodfen Raptor
Воин Синежабрых	Bluegill Warrior
Щитоносец Сен'джин	Sen'jin Shieldmasta
Раненый рубака	Injured Blademaster
Морозный йети	Chillwind Yeti
Боевой голем	War Golem
Гоблин-телохранитель	Booty Bay Bodyguard
Бранящийся сержант	Abusive Sergeant
Эльфийская лучница	Elven Archer
Охотница на Иглошкурых	Razorfen Hunter
Огр-маг	Ogre Magi
Огр Тяжелого Кулака	Boulderfist Ogre
Гончая Недр	Core Hound
Железноклюв	Ironbeak Owl
Шальная ракетчица	Reckless Rocketeer
Зловещий кузнец	Spiteful Smith
Герой Штормграда	Stormwind Champion
Вождь Северного Волка	Frostwolf Warlord
Алчный наемник	Venture Co. Mercenary
Огонек	Wisp
Сторожевое древо	Ironbark Protector
Шквал клинков	Blade Flurry
Слово Тьмы: Боль	Shadow Word: Pain
Клирик Североземья	Northshire Cleric
Божественный дух	Divine Spirit
Голодный канюк	Starving Buzzard
Нага-целительница	Darkscale Healer
Псарь	Houndmaster
Лесной волк	Timber Wolf
Тундровый люторог	Tundra Rhino
Залп	Multi-Shot
Выслеживание	Tracking
Чародейский выстрел	Arcane Shot
Длинный лук	Gladiator's Longbow
Взрыв разума	Mind Blast
Стражница Света	Lightwarden
Черный рыцарь	The Black Knight
Молодая жрица	Young Priestess
Опытный охотник	Big Game Hunter
Тревого-бот	Alarm-o-Bot
Служитель боли	Acolyte of Pain
Сквайр Авангарда	Argent Squire
Злая курица	Angry Chicken
Ворген-разведчик	Worgen Infiltrator
Знахарь вуду	Voodoo Doctor
Маг крови Талнос	Bloodmage Thalnos
Король Мукла	King Mukla
Инженер-новичок	Novice Engineer
Сильвана Ветрокрылая	Sylvanas Windrunner
Тропическая пантера	Jungle Panther
Священник син'дорай	Shattered Sun Cleric
Алый крестоносец	Scarlet Crusader
Провидец Траллмара	Thrallmar Farseer
Страж Луносвета	Silvermoon Guardian
Дракономеханик	Dragonling Mechanic
Тигр Тернистой долины	Stranglethorn Tiger
Лепрогном	Leper Gnome
Служительница солнца	Sunwalker
Неистовая гарпия	Windfury Harpy
Сумеречный дракон	Twilight Drake
Авантюрист	Questing Adventurer
Древний дозорный	Ancient Watcher
Дворф Черного Железа	Dark Iron Dwarf
Разрушитель чар	Spellbreaker
Молодой хмелевар	Youthful Brewmaster
Вайш'ирский оракул	Coldlight Oracle
Любительница маны	Mana Addict
Старый хмелевар	Ancient Brewmaster
Заступница син'дорай	Sunfury Protector
Безумный алхимик	Crazed Alchemist
Старый Мрачноглаз	Old Murk-Eye
Кислотный слизнюк	Acidic Swamp Ooze
Командир Авангарда	Argent Commander
Гном-призыватель	Pint-Sized Summoner
Хранительница тайн	Secretkeeper
Чокнутый подрывник	Mad Bomber
Мехмастер Замыкалец	Tinkmaster Overspark
Командир Песни Войны	Warsong Commander
Ментальный техник	Mind Control Tech
Чародейский голем	Arcane Golem
Жрица Тьмы	Cabal Shadow Priest
Защитник Аргуса	Defender of Argus
Гоблин-аукционист	Gadgetzan Auctioneer
Собиратель сокровищ	Loot Hoarder
Поганище	Abomination
Хранитель истории Чо	Lorewalker Cho
Разрушитель	Demolisher
Вайш'ирский провидец	Coldlight Seer
Горный великан	Mountain Giant
Кэрн Кровавое Копыто	Cairne Bloodhoof
Гелбин Меггакрут	Gelbin Mekkatorque
Лирой Дженкинс	Leeroy Jenkins
Потрошение	Eviscerate
Предательство	Betrayal
Замаскировать	Conceal
Веер клинков	Fan of Knives
Самопожертвование	Noble Sacrifice
Главарь Братства	Defias Ringleader
Око за око	Eye for an Eye
Клинок вечных мук	Perdition's Blade
Агент ШРУ	SI:7 Agent
Искупление	Redemption
Черепокол	Headcrack
Шаг сквозь тень	Shadowstep
Подготовка	Preparation
Гнев	Wrath
Знак природы	Mark of Nature
Душа леса	Soul of the Forest
Сила дикой природы	Power of the Wild
Близость к природе	Naturalize
Вожак лютых волков	Dire Wolf Alpha
Дар природы	Nourish
Друид когтя	Druid of the Claw
Хранитель чащи	Keeper of the Grove
Озарение	Innervate
Императорская кобра	Emperor Cobra
Звездный огонь	Starfire
Древо войны	Ancient of War
Молния	Lightning Bolt
Выброс лавы	Lava Burst
Пыледемон	Dust Devil
Сила тотемов	Totemic Might
Земной шок	Earth Shock
Сглаз	Hex
Топор бури	Stormforged Axe
Дух дикого волка	Feral Spirit
Барон Геддон	Baron Geddon
Элементаль земли	Earth Elemental
Раздвоенная молния	Forked Lightning
Вольный элементаль	Unbound Elemental
Гроза	Lightning Storm
Эфириал-чародей	Ethereal Arcanist
Конус холода	Cone of Cold
Чародейские стрелы	Arcane Missiles
Отравляющий укол	Shiv
Огненная глыба	Pyroblast
Ледяной элементаль	Frost Elemental
Лазурный дракон	Azure Drake
Антимагия	Counterspell
Ледяная преграда	Ice Barrier
Отраженная сущность	Mirror Entity
Ледяная глыба	Ice Block
Рагнарос	Ragnaros the Firelord
Страж Скверны	Felguard
Лик тлена	Mortal Coil
Пламя Тьмы	Shadowflame
Ужасень Бездны	Void Terror
Суккуб	Succubus
Ожог души	Soulfire
Вытягивание души	Siphon Soul
Страж ужаса	Doomguard
Круговерть Пустоты	Twisting Nether
Владыка преисподней	Pit Lord
Портал призыва	Summoning Portal
Переполняющая мощь	Power Overwhelming
Чутье на демонов	Sense Demons
Огненный бес	Flame Imp
Бич судьбы	Bane of Doom
Лорд Джараксус	Lord Jaraxxus
Немота	Silence
Темное безумие	Shadow Madness
Порождение Света	Lightspawn
Украденные мысли	Thoughtsteal
Колодец Света	Lightwell
Игры разума	Mindgames
Божественная милость	Divine Favor
Пророк Велен	Prophet Velen
Возложение рук	Lay on Hands
Благословение силы	Blessed Champion
Смирение	Humility
Заступник Авангарда	Argent Protector
Печать мудрости	Blessing of Wisdom
Гнев небес	Holy Wrath
Меч справедливости	Sword of Justice
Длань защиты	Hand of Protection
Покаяние	Repentance
Миротворец Алдоров	Aldor Peacekeeper
Тирион Фордринг	Tirion Fordring
Гнев карателя	Avenging Wrath
Таурен-воин	Tauren Warrior
Мощный удар	Slam
Боевая ярость	Battle Rage
Аманийский берсерк	Amani Berserker
Стражник Могу'шан	Mogu'shan Warden
Оружейница Арати	Arathi Weaponsmith
Берсерк Гурубаши	Gurubashi Berserker
Вихрь	Whirlwind
Мастер брони	Armorsmith
Щитоносец	Shieldbearer
Потасовка	Brawl
Смертельный удар	Mortal Strike
Улучшение	Upgrade!
Мощный удар щитом	Shield Slam
Кровавый вой	Gorehowl
Разъяренный ворген	Raging Worgen
Громмаш Адский Крик	Grommash Hellscream
Мурлок-волнолов	Murloc Tidehunter
Мурлок-полководец	Murloc Warleader
Оракул Темной Чешуи	Grimscale Oracle
Мурлок-волномут	Murloc Tidecaller
Терпеливый убийца	Patient Assassin
Гиена-падальщица	Scavenging Hyena
Перенаправление	Misdirection
Высокогрив саванны	Savannah Highmane
Лук Орлиного рога	Eaglehorn Bow
Разрывной выстрел	Explosive Shot
Спустить собак	Unleash the Hounds
Команда «Взять!»	Kill Command
Король Круш	King Krush
Осветительная ракета	Flare
Звериный гнев	Bestial Wrath
Змеиная ловушка	Snake Trap
Уборочный голем	Harvest Golem
Нат Пэгл	Nat Pagle
Харрисон Джонс	Harrison Jones
Архимаг Антонидас	Archmage Antonidas
Ноздорму	Nozdormu
Алекстраза	Alexstrasza
Ониксия	Onyxia
Малигос	Malygos
Безликий манипулятор	Faceless Manipulator
Тотем языка пламени	Flametongue Totem
Молот Рока	Doomhammer
Укус	Bite
Сила природы	Force of Nature
Изера	Ysera
Кенарий	Cenarius
Тотем прилива маны	Mana Tide Totem
Чудовище	The Beast
Дикость	Savagery
Ошеломление	Sap
Маг Даларана	Dalaran Mage
Жрица Элуны	Priestess of Elune
Древний маг	Ancient Mage
Морской великан	Sea Giant
Говорящий с ветром	Windspeaker
Рыцарь крови	Blood Knight
Аукенайская жрица	Auchenai Soulpriest
Ночной Клинок	Nightblade
Обращение в пар	Vaporize
Глава культа	Cult Master
Демонический огонь	Demonfire
Владычица бесов	Imp Master
Злой надсмотрщик	Cruel Taskmaster
Разъяренный берсерк	Frothing Berserker
Блок щитом	Shield Block
Внутренняя ярость	Inner Rage
Ученица чародея	Sorcerer's Apprentice
Снайперский выстрел	Snipe
Взрывная ловушка	Explosive Trap
Морозная ловушка	Freezing Trap
Маг Кирин-Тора	Kirin Tor Mage
Эдвин ван Клиф	Edwin VanCleef
Иллидан Ярость Бури	Illidan Stormrage
Магический призрак	Mana Wraith
Смертельный выстрел	Deadly Shot
Равенство	Equality
Огненный великан	Molten Giant
Круг исцеления	Circle of Healing
Слово Тьмы: Смерть	Shadow Word: Death
Храмовый боец	Temple Enforcer
Священный огонь	Holy Fire
Облик Тьмы	Shadowform
Массовое рассеивание	Mass Dispel
Вкусный зомби	Zombie Chow
Одержимый ползун	Haunted Creeper
Делящийся слизнюк	Echoing Ooze
Безумный ученый	Mad Scientist
Тень Наксрамаса	Shade of Naxxramas
Нерубское яйцо	Nerubian Egg
Призрачный рыцарь	Spectral Knight
Владыка Смерти	Deathlord
Мексна	Maexxna
Тенетник	Webspinner
Изрыгатель слизи	Sludge Belcher
Кел'Тузад	Kel'Thuzad
Сталагг	Stalagg
Фойген	Feugen
Стенающая душа	Wailing Soul
Властелин паутины	Nerub'ar Weblord
Раздвоение	Duplicate
Ядовитые семена	Poison Seeds
Отмщение	Avenge
Укус смерти	Death's Bite
Призыватель Бездны	Voidcaller
Темный сектант	Dark Cultist
Нестабильный вурдалак	Unstable Ghoul
Возрождение	Reincarnate
Неруб-душитель	Anub'ar Ambusher
Каменная горгулья	Stoneskin Gargoyle
Могильщик	Undertaker
Танцующие клинки	Dancing Swords
Лотхиб	Loatheb
Барон Ривендер	Baron Rivendare
Огненная пушка	Flamecannon
Снегочух	Snowchugger
Нестабильный портал	Unstable Portal
Гоблин-взрывомаг	Goblin Blastmage
Эхо Медива	Echo of Medivh
Механосборщик	Mechwarper
Огненный левиафан	Flame Leviathan
Световая бомба	Lightbomb
Теневой бомбардир	Shadowbomber
Избранник Велена	Velen's Chosen
Уменьшайстер	Shrinkmeister
Свет Наару	Light of the Naaru
Мастер шестеренок	Cogmaster
Вол'джин	Vol'jin
Темная бомба	Darkbomb
Сквернобот	Fel Reaver
Призыв питомца	Call Pet
Госпожа Боли	Mistress of Pain
Сердце демона	Demonheart
Пушка Скверны	Fel Cannon
Мал'Ганис	Mal'Ganis
Оружейное механомасло	Tinker's Sharpsword Oil
Авто-брадобрей	Goblin Auto-Barber
Гаечный ключ	Cogmaster's Wrench
Одноглазый плут	One-eyed Cheat
Притвориться мертвым	Feign Death
Железный сенсей	Iron Sensei
Принц Галливикс	Trade Prince Gallywix
Зов предков	Ancestor's Call
Ржавый медвежонок	Anodized Robo Cub
Переработка	Recycle
Хранительница рощи	Grove Tender
Древо Жизни	Tree of Life
Механо-медвекот	Mech-Bear-Cat
Малорн	Malorne
Палица силы	Powermace
Крутящийся меченосец	Whirling Zap-o-matic
Разряд	Crackle
Тотем жизни	Vitality Totem
Мурлок-духостранник	Siltfin Spiritwalker
Мрачный огонек	Dark Wispers
Нептулон	Neptulon
Метатель глеф	Glaivezooka
Танк-паук	Spider Tank
Бес-пощадный взрыв	Imp-losion
Царь зверей	King of Beasts
Диверсия	Sabotage
Железнозубый прыгун	Metaltooth Leaper
Газ'рилла	Gahz'rilla
Прыгучий сюрикэн	Bouncing Blade
Боевой робот	Warbot
Сокрушение	Crush
Защитница	Shieldmaiden
Боевой молот огров	Ogre Warmaul
Ржавый голем	Screwjank Clunker
Железный исполин	Iron Juggernaut
Печать Света	Seal of Light
Защищенный мини-бот	Shielded Minibot
Зубцевик	Coghammer
Интендант	Quartermaster
Призыв в бой	Muster for Battle
Кобальтовый страж	Cobalt Guardian
Болвар Фордрагон	Bolvar Fordragon
Грязевик	Puddlestomper
Огр-громила	Ogre Brute
Огр-шаман	Dunemaul Shaman
Трогг Камнедробов	Stonesplinter Trogg
Трогг Каменной Челюсти	Burly Rockjaw Trogg
Древний исцелятор	Antique Healbot
Просоленный моряк	Salty Dog
Заблудившийся долгоног	Lost Tallstrider
Теневой боксер	Shadowboxer
Выстрел кобры	Cobra Shot
Мистик Кезана	Kezan Mystic
Корабельная пушка	Ship's Cannon
Взрывоопасная овца	Explosive Sheep
Голем Анимуса	Anima Golem
Механический йети	Mechanical Yeti
Силовой танк	Force-Tank MAX
Друид-змея	Druid of the Fang
Жаблин-ловец	Gilblin Stalker
Заводной гном	Clockwork Gnome
Ремонтный супербот	Upgraded Repair Bot
Ветролет	Flying Machine
Раздражатор	Annoy-o-Tron
Осадная машина	Siege Engine
Снайпер из картеля	Steamwheedle Sniper
Огр-ниндзя	Ogre Ninja
Просветительница	Illuminator
Ошалевший подрывник	Madder Bomber
Чудо-обнулятор X-21	Arcane Nullifier X-21
Гном-экспериментатор	Gnomish Experimenter
Манекен-мишень	Target Dummy
Дживс	Jeeves
Гоблин-сапер	Goblin Sapper
Пилотируемый крошшер	Piloted Shredder
Юный экзорцист	Lil' Exorcist
Пехотинец Гномрегана	Gnomeregan Infantry
Бомбометатель	Bomb Lobber
Парящий страж	Floating Watcher
Освятитель Алого ордена	Scarlet Purifier
Гном-техник	Tinkertown Technician
Микроробот	Micro Machine
Хобгоблин	Hobgoblin
Небесный голем	Piloted Sky Golem
Хламобот	Junkbot
Механо-усилитель	Enhance-o Mechano
Рекомбинатор	Recombobulator
Мини-маг	Mini-Mage
Доктор Бум	Dr. Boom
Голова Мимирона	Mimiron's Head
Огр Могор	Mogor the Ogre
Врагорез-4000	Foe Reaper 4000
Старый крошшер Снида	Sneed's Old Shredder
Тошли	Toshley
Анжинер Термоштепсель	Mekgineer Thermaplugg
Газлоу	Gazlowe
Троггзор Терранатор	Troggzor the Earthinator
Блескотрон-3000	Blingtron 3000
Хеминг Эрнестуэй	Hemet Nesingwary
Заводной великан	Clockwork Giant
Контрзаклинательница	Wee Spellstopper
Изрыгатель сажи	Soot Spewer
Гаррош Адский Крик	Garrosh Hellscream
Магни Бронзобород	Magni Bronzebeard
Тралл	Thrall
Оракул Моргл	Morgl the Oracle
Валира Сангвинар	Valeera Sanguinar
Майев Песнь Теней	Maiev Shadowsong
Утер Светоносный	Uther Lightbringer
Леди Лиадрин	Lady Liadrin
Принц Артас	Prince Arthas
Рексар	Rexxar
Аллерия Ветрокрылая	Alleria Windrunner
Малфурион	Malfurion Stormrage
Гул'дан	Gul'dan
Немси Некропшик	Nemsy Necrofizzle
Джайна Праудмур	Jaina Proudmoore
Медив	Medivh
Кадгар	Khadgar
Андуин Ринн	Anduin Wrynn
Тиранда Шелест Ветра	Tyrande Whisperwind
Призрачный корсар	Phantom Freebooter
Скелемант	Skelemancer
Взрывной нетопырь	Exploding Bloatbat
Снежный прыгвин	Snowflipper Penguin
Костяной плут	Rattling Rascal
Мрачный некромант	Grim Necromancer
Костяной дракон	Bone Drake
Светозарная валь'кира	Sunborne Val'kyr
Кобальтовый губитель	Cobalt Scalebane
Ночной завыватель	Night Howler
Ядомант	Venomancer
Надменный рыцарь	Arrogant Crusader
Праведная защитница	Righteous Protector
Неправедный суд	Dark Conviction
Осквернение	Defile
Пряха Судьбы	Fatespinner
Токсичная стрела	Toxic Arrow
Паутина	Webweave
Друид-роевик	Druid of the Swarm
Ложная смерть	Play Dead
Ползучая чума	Spreading Plague
Похищение души	Drain Soul
Криостаз	Cryostasis
Брррлок	Brrrloc
Пламенеющий доспех	Mountainfire Armor
Кровавый клинок	Blood Razor
Повелитель костей	Bone Baron
Врайдалак	Vryghoul
Ледяной ходок	Ice Walker
Жуткая кудесница	Ghastly Conjurer
Скорбь Света	Light's Sorrow
Гадкий натрезим	Despicable Dreadlord
Лавина	Avalanche
Мертвая хватка	Gnash
Защитник драккари	Drakkari Defender
Ледяные двойники	Frozen Clone
Обреченная ученица	Doomed Apprentice
Тотальное заражение	Ultimate Infestation
Ледяные загадки	Glacial Mysteries
Проклинательница	Voodoo Hexxer
Подледная ловля	Ice Fishing
Снежный великан	Snowfury Giant
Рука мертвеца	Dead Man's Hand
Ветеран Акеруса	Acherus Veteran
Клыкарр-рыболов	Tuskarr Fisherman
Падшая син'дорай	Fallen Sun Cleric
Тигельный колосс	Furnacefire Colossus
Могильный громадень	Grave Shambler
Могильный скрытень	Tomb Lurker
Тикающее поганище	Ticking Abomination
Ядовитая ловушка	Venomstrike Trap
Бросок костей	Roll the Bones
Профессор Мерзоцид	Professor Putricide
Вероломство	Treachery
Пожирание разума	Devour Mind
Прислужница Тени	Shadow Ascendant
Служитель агонии	Acolyte of Agony
Вечное служение	Eternal Servitude
Обсидиановая статуя	Obsidian Statue
Архиепископ Бенедикт	Archbishop Benedictus
Воющая тварь	Howlfiend
Рыцарь Мертвожабрых	Deadscale Knight
Похищающий жизнь яд	Leeching Poison
Умеранг	Doomerang
Сущность тени	Shadow Essence
Ледорез	Ice Breaker
Оживленный берсерк	Animated Berserker
Рунный упырь	Runeforge Haunter
Трупная вдова	Corpse Widow
До последнего вздоха	Desperate Stand
Черный страж	Blackguard
Хладный дух	Coldwraith
Воскреситель мертвых	Corpse Raiser
Кузня Душ	Forge of Souls
Мураби	Moorabi
Король-лич	The Lich King
Гниломорд	Rotface
Гномферату	Gnomeferatu
Похитительница душ	Val'kyr Soulclaimer
Заштопанный следопыт	Stitched Tracker
Медвекула	Bearshark
Загробный гость	Death Revenant
Дренеи-каторжники	Saronite Chain Gang
Вестница смерти	Deathspeaker
Проклятый фермер	Wretched Tiller
Невольная жертва	Unwilling Sacrifice
Провидец смерти Тралл	Thrall, Deathseer
Веселый вурдалак	Happy Ghoul
Крадущийся упырь	Skulking Geist
Гробокопательница	Shallow Gravedigger
Костяная кобыла	Bonemare
Нерубский мастер сетей	Nerubian Unraveler
Воющий командир	Howling Commander
Астральная плеть	Spirit Lash
Крепкий мародер	Strongshell Scavenger
Владыка склепа	Crypt Lord
Исследователь чумы	Plague Scientist
Каратель с топором	Deathaxe Punisher
Лилиан Восс	Lilian Voss
Мясной фургон	Meat Wagon
Рыцарь Ледяного Клинка	Chillblade Champion
Симулякр	Simulacrum
Поганый стрелок	Abominable Bowman
Валира Иссохшая	Valeera the Hollow
Ловчий смерти Рексар	Deathstalker Rexxar
Утер Черный Клинок	Uther of the Ebon Blade
Темный жнец Андуин	Shadowreaper Anduin
Кровопийца Гул'дан	Bloodreaver Gul'dan
Малфурион Пагубный	Malfurion the Pestilent
Ледяной лич Джайна	Frost Lich Jaina
Владыка Плети Гаррош	Scourgelord Garrosh
Хадронокс	Hadronox
Дыхание Синдрагосы	Breath of Sindragosa
Кто на меня?!	Bring It On!
Синдрагоса	Sindragosa
Королева Лана'тель	Blood-Queen Lana'thel
Темные объятия	Embrace Darkness
Теневой клинок	Shadowblade
Принц Келесет	Prince Keleseth
Принц Талдарам	Prince Taldaram
Принц Валанар	Prince Valanar
Псартас	Arfus
Хильдская всадница	Hyldnir Frostrider
Прядильщица чар	Spellweaver
Болвар Опаленный	Bolvar, Fireblood
Некротический упырь	Necrotic Geist
Чародейка драккари	Drakkari Enchanter
Сокрушитель разума	Mindbreaker
Кровавый гедонист	Sanguine Reveler
Злобный скелет	Wicked Skeleton
Кровавый червь	Bloodworm
Вороватый дух	Spectral Pillager
Голосящая банши	Keening Banshee
Похитительница трупов	Corpsetaker
Нечестивый фанатик	Tainted Zealot
Фокус-котус	Cat Trick
Бабушка	Kindly Grandmother
Скрытная охотница	Cloaked Huntress
Болтливая книга	Babbling Book
Страж Ночной Погибели	Nightbane Templar
Напыщенный актер	Pompous Thespian
Очищение	Purify
Злая колдунья	Wicked Witchdoctor
Сим-каражим!	Kara Kazham!
Спасай короля!	Protect the King!
Несчастье шута	Fool's Bane
Руническое яйцо	Runic Egg
Буфетный паучок	Pantry Spider
Книгозмей	Book Wyrm
Жрец-обжора	Priest of the Feast
Волшебная аномалия	Arcane Anomaly
Пернатый страж	Avian Watcher
Канавный скрытень	Moat Lurker
Мороуз	Moroes
Белый конь	Ivory Knight
Смотритель	The Curator
Историк Гнева Пустоты	Netherspite Historian
Призрачные когти	Spirit Claws
Зверовод	Menagerie Warden
Пират-пройдоха	Swashburglar
Эфириал-торговец	Ethereal Peddler
Портал: Водоворот	Maelstrom Portal
Портал: Лунная поляна	Moonglade Portal
Портал: Огненные Просторы	Firelands Portal
Портал: Луносвет	Silvermoon Portal
Бес Малчезара	Malchezaar's Imp
Портал: Стальгорн	Ironforge Portal
Лакей Медива	Medivh's Valet
Острая вилка	Deadly Fork
Зообот	Zoobot
Принц Малчезар	Prince Malchezaar
Хранитель Медив	Medivh, the Guardian
Барнс	Barnes
Черный слон	Onyx Bishop
Посудный голем	Silverware Golem
Колдовской ворон	Enchanted Raven
Зверомаг	Menagerie Magician
Волшебный кузнец	Arcanosmith
Волшебный великан	Arcane Giant
Иллюзионистка	Violet Illusionist
Забытый факел	Forgotten Torch
Кудесник-эфириал	Ethereal Conjurer
Смотритель музея	Museum Curator
Проклятие Рафаама	Curse of Rafaam
Обсидиановый крушитель	Obsidian Destroyer
Гадюка	Pit Snake
Рено Джексон	Reno Jackson
Расхититель гробниц	Tomb Pillager
Гремящий элементаль	Rumbling Elemental
Хранитель Ульдамана	Keeper of Uldaman
Туннельный трогг	Tunnel Trogg
Ископаемый ящер	Unearthed Raptor
Пустынный верблюд	Desert Camel
Ловушка с дротиками	Dart Trap
Яростная макака	Fierce Monkey
Черный археолог	Dark Peddler
Мурглвратности судьбы	Anyfin Can Happen
Священный суд	Sacred Trial
Драгоценный скарабей	Jeweled Scarab
Морская ведьма	Naga Sea Witch
Гориллабот А-3	Gorillabot A-3
Огромная жаба	Huge Toad
Могильный паук	Tomb Spider
Ездовой ящер	Mounted Raptor
Тропический совух	Jungle Moonkin
Джинн ветров	Djinni of Zephyrs
Анубисат-часовой	Anubisath Sentinel
Окаменелый дьявозавр	Fossilized Devilsaur
Сэр Финли Мрргглтон	Sir Finley Mrrgglton
Бранн Бронзобород	Brann Bronzebeard
Элиза Звездочет	Elise Starseeker
Камень призыва	Summoning Stone
Башня из пигмеев	Wobbling Runts
Великий вор Рафаам	Arch-Thief Rafaam
Погребение	Entomb
Шляпа исследователя	Explorer's Hat
Зловещая статуя	Eerie Statue
Древняя тень	Ancient Shade
Раскопанное зло	Excavated Evil
Все у нас мррглклассно!	Everyfin is Awesome
Статуя ворона	Raven Idol
Искательница Реликвария	Reliquary Seeker
Проклятый клинок	Cursed Blade
Оживленные доспехи	Animated Armor
Малый Плавник	Murloc Tinyfin
Ментальный крик	Psychic Scream
Грубый гомункул	Vulgar Homunculus
Кобольд-библиотекарь	Kobold Librarian
Темный пакт	Dark Pact
Крюконосец-разоритель	Hooked Reaver
Фал'дорайский странник	Fal'dorei Strider
Пещерная блестяшница	Cavern Shinyfinder
Кобольд-варвар	Kobold Barbarian
Оберег: малый аметист	Lesser Amethyst Spellstone
Длань-клинок	Bladed Gauntlet
Дубовая кожа	Barkskin
Голем из древостали	Ironwood Golem
Оберег: малая яшма	Lesser Jasper Spellstone
Развилка	Branching Paths
Астральный тигр	Astral Tiger
Сокрушающая длань	Crushing Hand
Кобольд-отшельник	Kobold Hermit
Оберег: малый сапфир	Lesser Sapphire Spellstone
Обитатель стоков	Sewer Crawler
Обходной удар	Flanking Strike
Пещерная гидра	Cave Hydra
Блуждающий монстр	Wandering Monster
Оберег: малый изумруд	Lesser Emerald Spellstone
Рок'делар	Rhok'delar
Зелье героизма	Potion of Heroism
Оберег: малая жемчужина	Lesser Pearl Spellstone
К оружию!	Call to Arms
Взрывающиеся руны	Explosive Runes
Оберег: малый рубин	Lesser Ruby Spellstone
Свиток-перевертыш	Shifting Scroll
Колода чудес	Deck of Wonders
Алунет	Aluneth
Скорпобот	Scorp-o-matic
Восковой элементаль	Wax Elemental
Дракон-кузнец	Ebon Dragonsmith
Едкий слизнюк	Corrosive Sludge
Герой-одиночка	Lone Champion
Камнекожий василиск	Stoneskin Basilisk
Магический деспот	Arcane Tyrant
Зеленое желе	Green Jelly
Убийца драконов	Dragonslayer
Зубастый сундук	Toothy Chest
Демон-проныра	Sneaky Devil
Спящая драконица	Sleepy Dragon
Запасливый дракон	Hoarding Dragon
Коридорный ужас	Corridor Creeper
Фурболг-мохомант	Furbolg Mossbinder
Громкоголосый бард	Boisterous Bard
Лиловый червь	Violet Wurm
Камнерыл-рыцарь	Gravelsnout Knight
Плотоядный куб	Carnivorous Cube
Соня Тенепляс	Sonya Shadowdancer
Грибомант	Fungalmancer
Ворон-фамилиар	Raven Familiar
Ярость дракона	Dragon's Fury
Стражница авангарда	Silver Vanguard
Зов сумерек	Twilight's Call
Мерцающий скакун	Shimmering Courser
Оберег: малый мифрил	Lesser Mithril Spellstone
Обман смерти	Cheat Death
Душа дракона	Dragon Soul
Внезапное предательство	Sudden Betrayal
Эльф-менестрель	Elven Minstrel
Ускользание	Evasion
Линесса Печаль Солнца	Lynessa Sunsorrow
Ко мне!	To My Side!
Дикий бормотун	Feral Gibberer
Свечкострел	Candleshot
Магический бронник	Arcane Artificer
Проклятый ученик	Cursed Disciple
Жуткий крот	Dire Mole
Неопознанный эликсир	Unidentified Elixir
Неопознанный щит	Unidentified Shield
Неопознанный молот	Unidentified Maul
Грибовар	Shroom Brewer
Одержимый лакей	Possessed Lackey
Зов чащобы	Oaken Summons
Хрустальный лев	Crystal Lion
Косолапый страж	Grizzled Guardian
Трогг-мрачноед	Trogg Gloomeater
Архигриб Икслид	Ixlid, Fungal Lord
Новый уровень!	Level Up!
Талисманы стихий	Primal Talismans
Кобольд-адепт	Kobold Apprentice
Жадный дух	Greedy Sprite
Псионный зонд	Psionic Probe
Марин Лис	Marin the Fox
Грамбл, сотрясатель миров	Grumble, Worldshaker
Кобольд-тюремщик	Drygulch Jailor
Шквал гнева	Reckless Flurry
Инкрустированный голем	Gemstudded Golem
Сухоус-бронник	Drywhisker Armorer
Повелитель Бездны	Voidlord
Всей группой!	Gather Your Party
Целительный ливень	Healing Rain
Вербовщица гильдии	Guild Recruiter
Бедоруб	Woecleaver
Кобольд-монах	Kobold Monk
Голодный эттин	Hungry Ettin
Гриб-чародел	Fungal Enchanter
Кобольд-барахольщик	Rummaging Kobold
Ветвь Древа Жизни	Twig of the World Tree
Визжащий гриб	Shrieking Shroom
Великодушный джинн	Benevolent Djinn
Вестник заката	Duskbreaker
Кобольд-иллюзионист	Kobold Illusionist
Бронированный жук	Plated Beetle
Великий архивариус	Grand Archivist
Первоученица Рин	Rin, the First Disciple
Катаклизм	Cataclysm
Череп Ман'ари	Skull of the Man'ari
Вал'анир	Val'anyr
Оберег: малый оникс	Lesser Onyx Spellstone
Изменчивая эволюция	Unstable Evolution
Рунное копье	The Runespear
Оберег: малый алмаз	Lesser Diamond Spellstone
Катрена Зимний Шорох	Kathrena Winterwisp
Зола Горгона	Zola the Gorgon
Рокочущий элементаль	Murmuring Elemental
Ветрорез-призыватель	Windshear Stormcaller
Геоскульптор Йип	Geosculptor Yip
Журчащий слизнюченыш	Seeping Oozeling
Мастер Сердцедуб	Master Oakheart
Сокрушающие стены	Crushing Walls
Тьма	The Darkness
Сумеречный послушник	Twilight Acolyte
Потрошитель Бездны	Void Ripper
Золоченая горгулья	Gilded Gargoyle
Дракономант Аланна	Dragoncaller Alanna
Элементаль-манипулятор	Leyline Manipulator
Темпорус	Temporus
Злая призывательница	Spiteful Summoner
Драконозаводчик	Dragonhatcher
Король Вихлепых	King Togwaggle
Погибель королей	Kingsbane
Жертвенный договор	Sacrificial Pact
Исчезновение	Vanish
Похититель	Kidnapper
Звездопад	Starfall
Древо мудрости	Ancient of Lore
Ал'акир	Al'Akir the Windlord
Кор'кронский воин	Kor'kron Elite
Маназмей	Mana Wyrm
Мастер маскировки	Master of Disguise
Попугай капитана	Captain's Parrot
Голодный краб	Hungry Crab
Дерзкая налетчица	Bloodsail Raider
Жонглер кинжалами	Knife Juggler
Яростный пиромант	Wild Pyromancer
Вестник рока	Doomsayer
Жуткий корсар	Dread Corsair
Чудесный дракончик	Faerie Dragon
Капитан Зеленямс	Captain Greenskin
Кровожадный корсар	Bloodsail Corsair
Учительница магии	Violet Teacher
Капитан Южных морей	Southsea Captain
Миллхаус Манашторм	Millhouse Manastorm
Смертокрыл	Deathwing
Питомец	Animal Companion
Командирский крик	Commanding Shout
Мастер ковки клинков	Master Swordsmith
Груул	Gruul
Дробитель	Hogger
Несущийся кодо	Stampeding Kodo
Мурквизитор	Vilefin Inquisitor
Сила стихий	Primal Fusion
Пламенный безликий	Flamewreathed Faceless
Вечный страж	Eternal Sentinel
Эволюция	Evolve
Нечто из глубин	Thing from Below
Молот Сумерек	Hammer of Twilight
Цепкие щупальца	Tentacles for Arms
Силитид-членистоног	Silithid Swarmer
И'Шарадж	Y'Shaarj, Rage Unbound
Фэндрал Олений Шлем	Fandral Staghelm
Заражение	Infest
Звериное неистовство	Feral Rage
Метка И'Шараджа	Mark of Y'Shaarj
Запретное древо	Forbidden Ancient
Охота	On the Hunt
Сектант-убийца	Bladed Cultist
Путь через глубины	Journey Below
Скорополоховый чай	Thistle Tea
Ксарил	Xaril, Poisoned Mind
Раскол	Shatter
Мутировавший кобольд	Evolved Kobold
Сумеречный пиромант	Twilight Flamecaller
Безумный служитель льда	Demented Frostcaller
Запретное пламя	Forbidden Flame
Слуга Йогг-Сарона	Servant of Yogg-Saron
Фолиант заговорщика	Cabalist's Tome
Слово силы: Щупальца	Power Word: Tentacles
Сумеречная целительница	Twilight Darkmender
Слово Тьмы: Ужас	Shadow Word: Horror
Запретная форма	Forbidden Shaping
Темный проповедник	Darkspeaker
Объятия Тьмы	Embrace the Shadow
Библиотекарь Темнолесья	Darkshire Librarian
Член совета Темнолесья	Darkshire Councilman
Запретный ритуал	Forbidden Ritual
Заразительное безумие	Spreading Madness
Отречение от Тьмы	Renounce Darkness
Аномалус	Anomalus
Чо'Галл	Cho'gall
Мукла, Гроза Долины	Mukla, Tyrant of the Vale
Оборотень Зерус	Shifter Zerus
Император Век'лор	Twin Emperor Vek'lor
Н'Зот	N'Zoth, the Corruptor
Йогг-Сарон	Yogg-Saron, Hope's End
Нерубский пророк	Nerubian Prophet
Безликий гигант	Faceless Behemoth
Зловещий ужас	Eldritch Horror
Психонатор	Psych-o-Tron
Оскверненный исцелятор	Corrupted Healbot
Буйный вурдалак	Ravaging Ghoul
Искаженный берсерк	Aberrant Berserker
Щупальце Н'Зота	Tentacle of N'Zoth
Уродливый дракондор	Grotesque Dragonhawk
Болотный ползун	Bog Creeper
Порочный волнолов	Bilefin Tidehunter
Ревностный аколит	Zealous Initiate
Падший провидец	Corrupted Seer
Поборник К'Туна	Disciple of C'Thun
Кровь Древнего	Blood of The Ancient One
Безликий шаркун	Faceless Shambler
Теневой удар	Shadow Strike
Огненный нетопырь	Fiery Bat
Прядильщик клакси	Klaxxi Amber-Weaver
Древние огоньки	Wisps of the Old Gods
Запретное исцеление	Forbidden Healing
Вестник доказанного рока	Validated Doomsayer
Хранитель болот	Mire Keeper
Удар молнии	Stormcrack
Безликий призыватель	Faceless Summoner
Халлазил Перерожденный	Hallazeal the Ascended
Зов лесов	Call of the Wild
Зараженный волк	Infested Wolf
Храбрец Кровавого Копыта	Bloodhoof Brave
Малкорок	Malkorok
Самоотверженная героиня	Selfless Hero
Объединяющий клинок	Rallying Blade
Божественная сила	Divine Strength
Рагнарос Слуга Света	Ragnaros, Lightlord
Алхимик Темнолесья	Darkshire Alchemist
Погибель!	DOOM!
Одержимый крестьянин	Possessed Villager
Искаженный ворген	Twisted Worgen
Яростень Ам'гам	Am'gam Rager
Зараженный таурен	Infested Tauren
Пожиратель секретов	Eater of Secrets
Призыватель Рока	Doomcaller
Порождение Н'Зота	Spawn of N'Zoth
Кальмарный пират	Southsea Squidface
Чешуйчатый кошмар	Scaled Nightmare
Сумеречный призыватель	Twilight Summoner
Преграда на пути Тьмы	Stand Against Darkness
Кровавые воины	Blood Warriors
К'Тун	C'Thun
Зовущая Зло	Beckoner of Evil
Клинок К'Туна	Blade of C'Thun
Избранница К'Туна	C'Thun's Chosen
Сумеречный геомант	Twilight Geomancer
Сумеречный предок	Twilight Elder
Древняя предвестница	Ancient Harbinger
Темная чародейка	Shadowcaster
Одинокий охотник	Forlorn Stalker
Темный араккоа	Dark Arakkoa
Аптекарь-сектант	Cult Apothecary
Букамонстр	The Boogeymonster
Древний щитоносец	Ancient Shieldbearer
Привратница душ	Usher of Souls
Колдунья-сектантка	Cult Sorcerer
Огромный песчаный червь	Giant Sand Worm
Принцесса Хухуран	Princess Huhuran
Распорядитель Темнолесья	Steward of Darkshire
Свет во Тьме	A Light in the Darkness
Первый помощник Н'Зота	N'Zoth's First Mate
Обезумевший гризли	Addled Grizzly
Кровь и гной	Blood To Ichor
Пират-сектантка	Bloodsail Cultist
Глашатай Волаж	Herald Volazj
Владыка Смертокрыл	Deathwing, Dragonlord
Кошмарный Дробитель	Hogger, Doom of Elwynn
Полночный дракон	Midnight Drake
Безумный служитель	Crazed Worshipper
Пират Черноводья	Blackwater Pirate
Грязный барахольщик	Polluted Hoarder
Личинка-падальщик	Carrion Grub
Темный вепрь	Duskboar
Извивающееся щупальце	Squirming Tentacle
Мастер эволюции	Master of Evolution
Торговец из Подгорода	Undercity Huckster
Скрытная послушница	Hooded Acolyte
Изменчивая тень	Shifting Shade
Одноглазый ужас	Cyclopian Horror
Нат, Темный Рыболов	Nat, the Darkfisher
Сектант Скерама	Skeram Cultist
Соггот	Soggoth the Slitherer
E.T.C.	Elite Tauren Chieftain
Плотоядный вурдалак	Flesheating Ghoul
Чароплет	Spellbender
Птенец терродактиля	Pterrordax Hatchling
Вулканозавр	Volcanosaur
Динозаврение	Dinosize
Малыш-равазавр	Ravasaur Runt
Сытый жесткозуб	Sated Threshadon
Гидролог	Hydrologist
Хранитель Солнца Тарим	Sunkeeper Tarim
Огненный гейзер	Flame Geyser
Элементаль воздуха	Air Elemental
Арканолог	Arcanologist
Паровая туча	Steam Surger
Призыватель миражей	Mirage Caller
Узы маны	Mana Bind
Вулкан	Volcano
Пирос	Pyros
Связующая спираль	Open the Waygate
Темные видения	Shadow Visions
Связующее исцеление	Binding Heal
Кристаллический оракул	Crystalline Oracle
Сияющий элементаль	Radiant Elemental
Чудной сверкорень	Curious Glimmerroot
Тортолльская стражница	Tortollan Shellraiser
Ненасытный терродактиль	Ravenous Pterrordax
Смоляной скрытень	Tar Lurker
Шквал остроцветов	Razorpetal Volley
Колкий остроцвет	Razorpetal Lasher
Мимикрия	Mimic Pod
Обсидиановый осколок	Obsidian Shard
Кусачник	Biteweed
Кровожадный злолист	Vilespine Slayer
Шеразин	Sherazin, Corpse Flower
Подземные пещеры	The Caverns Below
Тол'вирский камнемаг	Tol'vir Stoneshaper
Огромный мастодонт	Giant Mastodon
Защитник холмов	Stonehill Defender
Озерный охотник	Rockpool Hunter
Коварный птенец	Vicious Fledgling
Яйцекрад	Eggnapper
Тортолльская сборщица	Tortollan Forager
Ледяной сокрушитель	Frozen Crusher
Рокочущий ящер	Thunder Lizard
Яйцо дьявозавра	Devilsaur Egg
Феникс Огненного Венца	Fire Plume Phoenix
Изумрудная королева	Emerald Hive Queen
Огромная анаконда	Giant Anaconda
Гидра Горьких Волн	Bittertide Hydra
Тортолльская шаманка	Tortollan Primalist
Кроткий мегазавр	Gentle Megasaur
Заряженный дьявозавр	Charged Devilsaur
Зеленое длинношеее	Verdant Longneck
Перевертыш	Shellshifter
Споры роста	Evolving Spores
Земляная чешуя	Earthen Scales
Древнее длинношеее	Elder Longneck
Живая мана	Living Mana
Зоркая разведчица	Bright-Eyed Scout
Исполины джунглей	Jungle Giants
Тотем палеомурлоков	Primalfin Totem
Вестник Огненного Венца	Fire Plume Harbinger
Ледниковый осколок	Glacial Shard
Каменный часовой	Stone Sentinel
Калимос Первородный	Kalimos, Primal Lord
Ловчий злобноплав	Terrorscale Stalker
Рух-наседка	Nesting Roc
Изумрудный разоритель	Emerald Reaver
Ультразавр	Ultrasaur
Ползун Голакка	Golakka Crawler
Упрямый брюхоног	Stubborn Gastropod
Огневичок	Fire Fly
Стегодон	Stegodon
Хищный саблезуб	Sabretooth Stalker
Страж бурь	Stormwatcher
Гигантская оса	Giant Wasp
Слуга Калимоса	Servant of Kalimos
Гнев прилива	Tidal Surge
Нестабильный элементаль	Volatile Elemental
Отравленное оружие	Envenom Weapon
Жертва Лаккари	Lakkari Sacrifice
Жестокий диномант	Cruel Dinomancer
Пелена порчи	Corrupting Mist
Кроволист	Bloodbloom
Гончая Лаккари	Lakkari Felhound
Налетай!	Feeding Time
Стрекочущий землерой	Chittering Tunneler
Королева Завас	Clutchmother Zavas
Смоляной дух	Tar Lord
Охотник Хеминг	Hemet, Jungle Hunter
Воракс	The Voraxx
Исполинский бритволист	Humongous Razorleaf
Пылкий элементаль	Igneous Elemental
Проблеск бури	Shimmering Tempest
Вестник зарева	Blazecaller
Доисторический дракон	Primordial Drake
Первопроходец Элиза	Elise the Trailblazer
Тирантий	Tyrantus
Нечто из янтаря	Free From Amber
Иллюзия	Hallucination
Волхвица Умбра	Spiritsinger Umbra
Озрук	Ozruk
Болезненный укус	Grievous Bite
Самоцветный ара	Jeweled Macaw
Тол'вирский часовой	Tol'vir Warden
Детеныш ящера	Raptor Hatchling
Искрящий острозуб	Crackling Razormaw
Дикий гон	Stampede
Диномантия	Dinomancy
Король болот Дред	Swamp King Dred
Королева болот	The Marsh Queen
Изучение Ун'Горо	Explore Un'Goro
Железная шкура	Iron Hide
Злой дикорог	Ornery Direhorn
Разведчица в беде	Cornered Sentry
Внезапногенез	Sudden Genesis
Смоляной страж	Tar Creeper
Клинок из лавы	Molten Blade
Король Мош	King Mosh
Сердце Огненного Венца	Fire Plume's Heart
Палеомурлок-разведчик	Primalfin Lookout
Страж гейзера	Hot Spring Guardian
Пробуждение творцов	Awaken the Makers
Петроглиф	Primordial Glyph
Мурлочий союз	Unite the Murlocs
Прожорливая слизь	Gluttonous Ooze
Копия из лавы	Molten Reflection
Лозоруб	Vinecleaver
Гребнистый скакун	Spikeridged Steed
Палеомурлок-защитник	Primalfin Champion
Последний калейдозавр	The Last Kaleidosaur
Метеорит	Meteor
Отголоски духов	Spirit Echo
Детеныш дикорога	Direhorn Hatchling
Заблудившиеся в джунглях	Lost in the Jungle
Адаптация	Adaptation
Сияющий стегодон	Lightfused Stegodon
Лира Осколок Солнца	Lyra the Sunshard
