Flammenlanze	Огненное копье
Effigie	Чучело
Gefallener Held	Павший герой
Arkanschlag	Чародейская вспышка
Verwandlung: Eber	Превращение в вепря
Streiter von Dalaran	Боец из Даларана
Zauberkünstler	Чаромет
Drache von Kaltarra	Дракон Хладарры
Rhonin	Ронин
Wilder Widderbändiger	Пастух
Heiliger Champion	Святая защитница
Ausgeburt der Schatten	Исчадие теней
Machtwort: Ruhm	Слово силы: Слава
Schattengeist	Исчадие Тьмы
Bekehren	Обращение
Verwirren	Замешательство
Zwielichtwächter	Сумеречный страж
Beichtpatin Blondlocke	Исповедница Пейлтресс
Schreckensross	Конь погибели
Fiese Verdammniswache	Грозный демон
Miniritter des Bösen	Малый рыцарь зла
Jaraxxus' Faust	Кулак Джараксуса
Leervernichter	Крушитель из Бездны
Dämonische Fusion	Демоническая сила
Finsterer Handel	Темная сделка
Zornwächter	Страж гнева
Wilfred Zischknall	Вилфред Непопамс
Shado-Pan-Reiter	Всадник Шадо-Пан
Bukanier	Буканьер
Recke von Unterstadt	Рыцарь Подгорода
Taschendieb	Карманник
Zwielichtiger Händler	Сомнительный делец
Lange Finger	Воришка
Vergiftete Klinge	Отравленное лезвие
Unter dem Kolosseum	Из-под земли
Anub'arak	Ануб'арак
Lebendige Wurzeln	Живые корни
Streiterin von Darnassus	Боец из Дарнаса
Wilder Kämpfer	Яростный воин
Wildläuferin	Дикая странница
Ritter der Wildnis	Рыцарь чащи
Druidin des Säbelzahns	Друид-саблезуб
Astrale Vereinigung	Астральное единение
Kompostieren	Мульчирование
Aviana	Авиана
Totemiker der Tuskarr	Клыкарр-шаман
Draenei-Totemschnitzerin	Резчица тотемов
Welle der Heilung	Волна исцеления
Recke von Donnerfels	Рыцарь Громового Утеса
Aufgeladener Hammer	Магический молот
Elementare Zerstörung	Разрушительные стихии
Totemgolem	Тотемный голем
Wissen der Ahnen	Древнее знание
Der Nebelrufer	Призыватель туманов
Blitzheilung	Быстрое исцеление
Überspannen	Мощный выстрел
Stallmeisterin	Главный конюх
Elekk des Königs	Королевский элекк
Schützin des Hochlands	Храбрая лучница
Bärenfalle	Медвежья ловушка
Geladen und entsichert	На изготовку!
Spinnennest	Паучий клубок
Ätzschlund	Кислотная Утроба
Schreckensmaul	Жуткая Чешуя
Schwungvoller Hieb	Оглушить
Königsverteidiger	Королевский поборник
Streiter von Orgrimmar	Боец из Оргриммара
Magnataurenalpha	Вожак магнатавров
Stärken	Усиление
Sparringspartner	Спарринг-партнер
Himmelskäpt'n Kragg	Крагг Поднебесный
Alexstraszas Champion	Защитница Алекстразы
Varian Wrynn	Вариан Ринн
Wetteifer	Боевой настрой
Siegel des Champions	Печать чемпионов
Schlachtrossausbilder	Боевой берейтор
Murlocritter	Мурлок-рыцарь
Argentumlanze	Серебряное копье
Betretet das Kolosseum	Вход в Колизей
Mysteriöser Ritter	Загадочный претендент
Garnisonskommandant	Командир гарнизона
Eadric der Reine	Эдрик Чистый
Einfacher Knappe	Скромный оруженосец
Drachenfalkenreiter	Всадник на дракондоре
Lanzenträger	Копьеносец
Maid des Sees	Озерная дева
Saboteur	Саботажник
Argentumreiter	Серебряный всадник
Mogors Champion	Защитник Могора
Knochenwachenleutnant	Костяной лейтенант
Muklas Champion	Защитник Муклы
Turniersanitäter	Лекарь турнира
Eiswüter	Ледяной яростень
Frierender Schneebold	Морозный снобольд
Flammenjongleur	Жонглер пламенем
Schweigsamer Ritter	Молчаливый рыцарь
Aufziehritter	Заводной рыцарь
Turnierzuschauer	Зритель турнира
Zauberschluckerin	Глотательница чар
Kodoreiterin	Всадница на кодо
Silberne Regentin	Паладин-регент
Grubenkämpferin	Боец арены
Gefangener Jormungar	Пленный йормунгар
Nordmeerkrake	Кракен Северного моря
Tuskarrtjoster	Бретер-клыкарр
Verletzter Kvaldir	Раненый квалдир
Champion des Lichts	Защитник Света
Gepanzertes Schlachtross	Бронированный скакун
Argentumwachmann	Серебряный дозорный
Meister des Kolosseums	Распорядитель Колизея
Imbissbuden-Tuskarr	Продавец закусок
Tjostmeister	Великий бретер
Anwerber	Вербовщик
Arglistiger Querulant	Злобный насмешник
Fechtlehrer	Учитель фехтования
Wyrmruhagent	Драконий посланник
Zeremonienmeisterin	Церемониймейстер
Oberste Kreuzfahrerin	Великий рыцарь
Räuber der Kvaldir	Квалдир-налетчик
Frostriese	Ледяной великан
Publikumsliebling	Кумир толпы
Gormok der Pfähler	Гормок
Frostschlund	Ледяная Пасть
Bolf Rammschild	Болф Таранный Щит
Eisheuler	Ледяной Рев
Nexus-Champion Saraad	Сараад, рыцарь Нексуса
Der Skelettritter	Рыцарь-скелет
Fjola Lichtbann	Фьола Погибель Света
Meeresplünderer	Гроза морей
Eydis Nachtbann	Эйдис Погибель Тьмы
Justiziarin Treuherz	Мариэль Чистосердечная
Tjosterin von Gadgetzan	Бретер из Прибамбасска
Andächtige Totenwache	Священное бдение
Flammenschürer	Поджигатель
Drachenodem	Дыхание дракона
Zwielichtwelpling	Сумеречный дракончик
Dämonenzorn	Демонический гнев
Boss der Wichtelgang	Главарь банды бесов
Dreierbande	Сходка
Dunkeleisenlauerer	Тихоступ Черного Железа
Vulkanborke	Вулканический древень
Druidin der Flamme	Друид пламени
Lavaschock	Лавовый шок
Brandwachenzerstörer	Огнестраж-разрушитель
Schneller Schuss	Скорострельность
Kernwüterich	Яростень Недр
Rache	Возмездие
Axtwerfer	Метатель топоров
Auferstehung	Воскрешение
Drachengefährte	Супруга дракона
Grimmiger Gast	Мрачный завсегдатай
Drachkinzauberer	Драконор-чародей
Drachenei	Яйцо дракона
Drakonidenzermalmer	Драконид-сокрушитель
Vulkandrache	Вулканический дракон
Hungriger Drache	Голодный дракон
Majordomus Exekutus	Мажордом Экзекутус
Imperator Thaurissan	Император Тауриссан
Rend Schwarzfaust	Ренд Чернорук
Nefarian	Нефариан
Chromaggus	Хромаггус
Pechschwingentechnikerin	Техник Крыла Тьмы
Pechschwingenverderber	Губитель Крыла Тьмы
Raza der Gefesselte	Раза Плененный
Frosttrank	Зелье заморозки
Aufziehbandit	Заводной воробот
Geheimversteck	Схрон
Trickbetrüger	Уличный фокусник
Roter Manawyrm	Алый маназмей
Jinyuwassersprecher	Говорящий с водой
Kiezbeschützer	Защитник трущоб
Durchgeknallter Chemiker	Чокнутый химик
Waltranbaron	Толстосум
Vulkanischer Trank	Вулканическое зелье
Lakai der Kabale	Прихвостень «Кабала»
Ho-zen-Heiler	Хозен-лекарь
Teufelsfeuertrank	Зелье огня Скверны
Wühlerwiesel	Пронырливая ласка
Meisterin der Mixturen	Мастерица микстур
Pflichtverteidiger	Адвокат
Schmuggeltour	Незаконный ввоз
Kun der Vergessene König	Кун, Забытый Король
Die Aufräumrgler	Мурлоковороты
Jadehäuptling	Нефритовый вождь
Zapp­za­rapp	Было ваше, стало наше!
Hinterhofstreuner	Бродячий кот
Rattenmeute	Крысиная стая
Kiezinformant	Осведомитель из трущоб
Weißauge	Млечноокий
Kleinbukanier	Мелкий буканьер
Kampfveranstalterin	Организатор боев
Dr. Faust	Кулакс
Schmuggelware	Контрабандный товар
Einsatzkodo	Патрульный кодо
Schießwütiger Strolch	Самопальщик
Piranhawerfer	Пиранострел
Troggdompteur	Трогг-погонщик
Wachtmeisterin Sally	Сержант Салли
Grummelbukanier	Удачливый буканьер
Jadebehemoth	Нефритовое чудище
Finja die Todesflosse	Мурлиндзя
Jadeidol	Нефритовый идол
Trank des Wahnsinns	Зелье безумия
Großer Heiltrank	Среднее лечебное зелье
Drakonidenagent	Драконид-шпион
Manageode	Мановая жеода
Kristalltilgtrank	Зелье взрыв-кристалла
Peiniger der Höllenorcs	Душегуб Скверны
Kristallwirker	Заклинатель кристаллов
Blutzorntrank	Зелье кровавой ярости
Zeichen des Lotus	Знак «Лотоса»
Kristallklau	Кража силы
Träumerin der Erhabenen	Небесная провидица
Chemikerin der Kabale	Химик «Кабала»
Verwandlungstrank	Зелье превращения
Kazakus	Казакус
Große arkane Geschosse	Чародейские суперстрелы
Kabalenkrallenpriester	Жрец Когтя из «Кабала»
Gefälschte Münze	Фальшивая монетка
Messingschlagring	Латунный кастет
Lotusassassine	Убийца из «Лотоса»
Schattenwüter	Яростень Тьмы
Käpt'n Glubschauge	Пират Глазастик
Kiezeintreiber	Громила из трущоб
Hobart Wurfhammer	Хобарт Дрек
Dubioser Lepragnom	Лепрогном из подворотни
Pfeilgiftmurloc	Снайпер Свистожабрых
Großstadtgangster	Матерый гангстер
Kurierin der Kabale	Курьер «Кабала»
Grimmschuppenkomplize	Живец Темной Чешуи
Nagakorsarin	Нага-корсар
Zweitklassiger Schläger	Второсортный костолом
Ein-Orc-Armee	Наемник
Netter Kneipenwirt	Радушный трактирщик
Toxischer Klärschlamm	Токсичный слизнюк
Gewiefter Detektiv	Уличный детектив
Stimmräuber der Kabale	Песнекрад «Кабала»
Taffer Türsteher	Вышибала
Gadgetzaner Sternchen	Светская львица
Manische Seelenwirkerin	Заклинательница душ
Schrumpftrank	Гномозелье
Drachenfeuertrank	Зелье драконьего огня
Schieberin der Kabale	Перевозчица «Кабала»
Worgenhalbstarker	Ворген-стиляга
Knatz-Fu-Meister	Мастер грук-фу
Bombenlegerin	Подрывница
Doppelgangster	Доппельгангстер
Glitzerstibitzer	Вороватый задира
Bürgermeister Noggenfogger	Мэр Гогельмогель
Kryomantin	Криомантка
Madame Goya	Мадам Гойя
Don Han'Cho	Дон Хан'Чо
Tintenmeisterin Solia	Каллиграф Солия
Pickelhaubenheizer	Шипастый хряк
Jadeshuriken	Нефритовый сюрикэн
Jadeschwärmer	Нефритовый роевик
Fährfrau von Gadgetzan	Паромщик
Schattensensei	Сенсей Тьмы
Devolution	Инволюция
Lotusillusionistin	Иллюзионистка «Лотоса»
Seeteufelstecher	Морской дьявол
Jadeblitz	Нефритовая молния
Jadeblüte	Нефритовый цветок
Jadegeist	Нефритовый дух
Bei den Fischen schlafen	На корм рыбам
Jadeklauen	Нефритовые когти
Krul der Entfesselte	Крул Освобожденный
Abyssalvollstrecker	Могучий абиссал
Diebesgut	Чужое добро
Kiezausstatter	Торговец из трущоб
Schmieriger Tüftler	«Бугай»-технарь
Kiezpfandleiherin	Ростовщица из трущоб
Hinterhofschmiedin	Уличная бронница
Korrupter Sheriff	Страж порядка
Kabalekristallkurierin	Разносчица кристаллов
Shaku der Sammler	Шаку Собиратель
Dreckige Ratte	Грязная крыса
Fluchtkodo	Побег на кодо
Furorion	Гневион
Auktionsmeister Barto	Аукционист Вихлюн
Genzo der Hai	Шулер Гензо
Tanaris-Borstenheizer	Турбохряк из Танариса
Boss der Borstenheizer	Главарь «Ночных хряков»
Lunare Visionen	Лунные видения
Brandbart Loderlunte	Сенопал Огнеус
Shed-Ling-Sensei	Гну-синь-сенсей
Rasende Reporterin	Бесстрашный репортер
Lotusagenten	Агенты «Лотоса»
Kiezschmugglerin	Контрабандистка
Urtum der Blüten	Древо цветения
Meuchler der Defias	Ликвидатор из Братства
Schwarzapotheker	Подпольный аптекарь
Aya Schwarzpfote	Айя Черная Лапа
Frischgebackene Rekruten	Мелкие сошки
Ich kenn da jemanden ...	Я знаю кое-кого
Fußsoldat von Goldhain	Солдат Златоземья
Moorkrabbler	Трясинный ползун
Heilige Nova	Кольцо света
Gedankenkontrolle	Контроль разума
Inneres Feuer	Внутренний огонь
Heilige Pein	Божественная кара
Gedankensicht	Внутреннее зрение
Machtwort: Schild	Слово силы: Щит
Klaue	Коготь
Heilende Berührung	Целебное касание
Mondfeuer	Лунный огонь
Mal der Wildnis	Знак дикой природы
Wildes Brüllen	Дикий рев
Prankenhieb	Размах
Wildwuchs	Буйный рост
Verwandlung	Превращение
Arkane Intelligenz	Интеллект чародея
Frostblitz	Ледяная стрела
Arkane Explosion	Чародейский взрыв
Frostnova	Кольцо льда
Spiegelbild	Зеркальные копии
Blizzard	Снежная буря
Feuerball	Огненный шар
Eislanze	Ледяное копье
Flammenstoß	Волна огня
Wasserelementar	Элементаль воды
Frostschock	Ледяной шок
Geist der Ahnen	Дух предков
Windzorn	Неистовство ветра
Heilung der Ahnen	Исцеление предков
Feuerelementar	Элементаль огня
Waffe des Felsbeißers	Камнедробитель
Kampfrausch	Жажда крови
Fernsicht	Дальнее зрение
Schattenblitz	Стрела Тьмы
Blutwichtel	Кровавый бес
Blutsauger	Похищение жизни
Höllenfeuer	Адское пламя
Verderbnis	Порча
Schreckenshöllenbestie	Жуткий инфернал
Leerwandler	Демон Бездны
Meucheln	Удар в спину
Kaltblütigkeit	Хладнокровие
Tödliches Gift	Смертоносный яд
Finsterer Stoß	Коварный удар
Attentat	Ликвидация
Sprinten	Спринт
Klinge des Assassinen	Клинок убийцы
Mal des Jägers	Метка охотника
Segen der Macht	Печать могущества
Wächter der Könige	Защитник королей
Heiliges Licht	Свет небес
Gerechtigkeit des Lichts	Правосудие Света
Segen der Könige	Печать королей
Weihe	Освящение
Hammer des Zorns	Молот гнева
Echtsilberchampion	Серебряный клинок
Sturmangriff	Рывок
Toben	Буйство
Heldenhafter Stoß	Удар героя
Feurige Kriegsaxt	Огненная секира
Hinrichten	Казнь
Arkanitschnitter	Арканитовый жнец
Spalten	Рассекающий удар
Seher des Irdenen Rings	Служитель Земли
Magmawüter	Магмовый яростень
Oasenschnappkiefer	Оазисный хрустогрыз
Flusskrokilisk	Речной кроколиск
Frostwolfgrunzer	Боец Северного Волка
Schlachtzugsleiter	Лидер рейда
Wolfsreiter	Всадник на волке
Eisenpelzgrizzly	Гризли-сталемех
Silberrückenpatriarch	Седоспин-патриарх
Ritter von Sturmwind	Рыцарь Штормграда
Schütze von Eisenschmiede	Ружейник Стальгорна
Koboldgeomant	Кобольд-геомант
Südmeerdeckmatrose	Матрос Южных морей
Gnomische Erfinderin	Гном-изобретатель
Sturmlanzenkommando	Дворф-диверсант
Ritter der Silbernen Hand	Рыцарь Длани
Erzmagier	Верховный маг
Rabenholdtassassine	Скрытный убийца
Herr der Arena	Повелитель арены
Murlocräuber	Мурлок-налетчик
Junger Drachenfalke	Молодой дракондор
Steinhauereber	Вепрь-камнеклык
Blutsumpfraptor	Ящер Кровавой Топи
Blaukiemenkrieger	Воин Синежабрых
Schildmeista von Sen'jin	Щитоносец Сен'джин
Verletzter Klingenmeister	Раненый рубака
Eiswindyeti	Морозный йети
Kriegsgolem	Боевой голем
Goblinleibwächter	Гоблин-телохранитель
Ruchloser Unteroffizier	Бранящийся сержант
Elfenbogenschützin	Эльфийская лучница
Jägerin der Klingenhauer	Охотница на Иглошкурых
Ogermagier	Огр-маг
Oger der Felsfäuste	Огр Тяжелого Кулака
Kernhund	Гончая Недр
Eisenschnabeleule	Железноклюв
Irre Raketenschützin	Шальная ракетчица
Hasserfüllte Schmiedin	Зловещий кузнец
Champion von Sturmwind	Герой Штормграда
Frostwolfkriegsfürst	Вождь Северного Волка
Söldner der Venture Co.	Алчный наемник
Irrwisch	Огонек
Eisenborkenbeschützer	Сторожевое древо
Klingenwirbel	Шквал клинков
Schattenwort: Schmerz	Слово Тьмы: Боль
Klerikerin von Nordhain	Клирик Североземья
Göttlicher Wille	Божественный дух
Verhungernder Bussard	Голодный канюк
Dunkelschuppenheilerin	Нага-целительница
Hundemeister	Псарь
Waldwolf	Лесной волк
Tundranashorn	Тундровый люторог
Mehrfachschuss	Залп
Fährtenlesen	Выслеживание
Arkaner Schuss	Чародейский выстрел
Langbogen des Gladiators	Длинный лук
Gedankenschlag	Взрыв разума
Lichtwächterin	Стражница Света
Der Schwarze Ritter	Черный рыцарь
Junge Priesterin	Молодая жрица
Großwildjäger	Опытный охотник
Alarm-o-Bot	Тревого-бот
Akolyth des Schmerzes	Служитель боли
Argentumknappin	Сквайр Авангарда
Wütendes Huhn	Злая курица
Worgenspitzel	Ворген-разведчик
Voodoodoktor	Знахарь вуду
Blutmagier Thalnos	Маг крови Талнос
König Mukla	Король Мукла
Ingenieurslehrling	Инженер-новичок
Sylvanas Windläufer	Сильвана Ветрокрылая
Dschungelpanther	Тропическая пантера
Blutelfenklerikerin	Священник син'дорай
Scharlachrote Fanatikerin	Алый крестоносец
Scharfseher von Thrallmar	Провидец Траллмара
Wache von Silbermond	Страж Луносвета
Drachlingmechanikerin	Дракономеханик
Schlingendorntiger	Тигр Тернистой долины
Lepragnom	Лепрогном
Sonnenläuferin	Служительница солнца
Windzornharpie	Неистовая гарпия
Zwielichtdrache	Сумеречный дракон
Rastloser Abenteurer	Авантюрист
Uralter Wächter	Древний дозорный
Dunkeleisenzwerg	Дворф Черного Железа
Zauberbrecher	Разрушитель чар
Junger Braumeister	Молодой хмелевар
Tiefenlichtorakel	Вайш'ирский оракул
Manasüchtige	Любительница маны
Uralter Braumeister	Старый хмелевар
Sonnenzornbeschützerin	Заступница син'дорай
Verrückter Alchemist	Безумный алхимик
Trübauge der Alte	Старый Мрачноглаз
Säurehaltiger Schlamm	Кислотный слизнюк
Argentumkommandant	Командир Авангарда
Winzige Beschwörerin	Гном-призыватель
Geheimnisbewahrerin	Хранительница тайн
Verrückter Bomber	Чокнутый подрывник
Tüftlermeister Oberfunks	Мехмастер Замыкалец
Kriegshymnenanführerin	Командир Песни Войны
Gedankenkontrolleur	Ментальный техник
Arkangolem	Чародейский голем
Kabaleschattenpriesterin	Жрица Тьмы
Verteidiger von Argus	Защитник Аргуса
Goblinauktionator	Гоблин-аукционист
Beutehamsterer	Собиратель сокровищ
Monstrosität	Поганище
Lehrensucher Cho	Хранитель истории Чо
Verwüster	Разрушитель
Tiefenlichtseher	Вайш'ирский провидец
Bergriese	Горный великан
Cairne Bluthuf	Кэрн Кровавое Копыто
Gelbin Mekkadrill	Гелбин Меггакрут
Leeroy Jenkins	Лирой Дженкинс
Ausweiden	Потрошение
Verrat	Предательство
Verhüllen	Замаскировать
Dolchfächer	Веер клинков
Heldenopfer	Самопожертвование
Rädelsführer der Defias	Главарь Братства
Auge um Auge	Око за око
Klinge des Verderbens	Клинок вечных мук
SI:7-Agent	Агент ШРУ
Erlösung	Искупление
Schädelbruch	Черепокол
Schattenschritt	Шаг сквозь тень
Vorbereitung	Подготовка
Zorn	Гнев
Mal der Natur	Знак природы
Seele des Waldes	Душа леса
Macht der Wildnis	Сила дикой природы
Kreislauf der Natur	Близость к природе
Terrorwolfalpha	Вожак лютых волков
Pflege	Дар природы
Druide der Klaue	Друид когтя
Hüter des Hains	Хранитель чащи
Anregen	Озарение
Kaiserkobra	Императорская кобра
Sternenfeuer	Звездный огонь
Urtum des Krieges	Древо войны
Blitzschlag	Молния
Lavaeruption	Выброс лавы
Staubteufel	Пыледемон
Macht der Totems	Сила тотемов
Erdschock	Земной шок
Verhexung	Сглаз
Sturmgeschmiedete Axt	Топор бури
Wildgeist	Дух дикого волка
Baron Geddon	Барон Геддон
Erdelementar	Элементаль земли
Gabelblitzschlag	Раздвоенная молния
Entfesselter Elementar	Вольный элементаль
Gewittersturm	Гроза
Astraler Arkanist	Эфириал-чародей
Kältekegel	Конус холода
Arkane Geschosse	Чародейские стрелы
Tückische Klinge	Отравляющий укол
Pyroschlag	Огненная глыба
Frostelementar	Ледяной элементаль
Azurblauer Drache	Лазурный дракон
Gegenzauber	Антимагия
Eisbarriere	Ледяная преграда
Spiegelgestalt	Отраженная сущность
Eisblock	Ледяная глыба
Ragnaros der Feuerfürst	Рагнарос
Teufelswache	Страж Скверны
Weltliche Ängste	Лик тлена
Schattenflamme	Пламя Тьмы
Schrecken der Leere	Ужасень Бездны
Sukkubus	Суккуб
Seelenfeuer	Ожог души
Seele entziehen	Вытягивание души
Verdammniswache	Страж ужаса
Wirbelnder Nether	Круговерть Пустоты
Grubenlord	Владыка преисподней
Beschwörungsportal	Портал призыва
Überwältigende Macht	Переполняющая мощь
Dämonen wahrnehmen	Чутье на демонов
Flammenwichtel	Огненный бес
Omen der Verdammnis	Бич судьбы
Lord Jaraxxus	Лорд Джараксус
Stille	Немота
Dunkler Wahnsinn	Темное безумие
Lichtbrut	Порождение Света
Gedankenraub	Украденные мысли
Lichtbrunnen	Колодец Света
Gedankenspiele	Игры разума
Göttliche Gunst	Божественная милость
Prophet Velen	Пророк Велен
Handauflegung	Возложение рук
Gesegneter Champion	Благословение силы
Demut	Смирение
Argentumbeschützer	Заступник Авангарда
Segen der Weisheit	Печать мудрости
Heiliger Zorn	Гнев небес
Schwert der Gerechtigkeit	Меч справедливости
Hand des Schutzes	Длань защиты
Buße	Покаяние
Friedensbewahrer	Миротворец Алдоров
Tirion Fordring	Тирион Фордринг
Zornige Vergeltung	Гнев карателя
Taurenkrieger	Таурен-воин
Zerschmettern	Мощный удар
Kampfeswut	Боевая ярость
Amaniberserker	Аманийский берсерк
Wächter von Mogu'shan	Стражник Могу'шан
Arathiwaffenschmiedin	Оружейница Арати
Gurubashiberserker	Берсерк Гурубаши
Wirbelwind	Вихрь
Rüstungsschmiedin	Мастер брони
Schildträger	Щитоносец
Scharmützel	Потасовка
Tödlicher Stoß	Смертельный удар
Aufwertung	Улучшение
Schildschlag	Мощный удар щитом
Blutschrei	Кровавый вой
Tobender Worgen	Разъяренный ворген
Grommash Höllschrei	Громмаш Адский Крик
Murlocgezeitenjäger	Мурлок-волнолов
Murlocanführer	Мурлок-полководец
Grimmschuppenorakel	Оракул Темной Чешуи
Murlocgezeitenrufer	Мурлок-волномут
Geduldiger Attentäter	Терпеливый убийца
Aasfressende Hyäne	Гиена-падальщица
Irreführung	Перенаправление
Savannenhochmähne	Высокогрив саванны
Adlerhornbogen	Лук Орлиного рога
Explosivschuss	Разрывной выстрел
Lasst die Hunde los!	Спустить собак
Fass!	Команда «Взять!»
König Knirsch	Король Круш
Leuchtfeuer	Осветительная ракета
Zorn des Wildtiers	Звериный гнев
Schlangenfalle	Змеиная ловушка
Erntegolem	Уборочный голем
Nat Pagle	Нат Пэгл
Harrison Jones	Харрисон Джонс
Erzmagier Antonidas	Архимаг Антонидас
Nozdormu	Ноздорму
Alexstrasza	Алекстраза
Onyxia	Ониксия
Malygos	Малигос
Gesichtsloser Manipulator	Безликий манипулятор
Flammenzungentotem	Тотем языка пламени
Schicksalshammer	Молот Рока
Biss	Укус
Naturgewalt	Сила природы
Ysera	Изера
Cenarius	Кенарий
Manafluttotem	Тотем прилива маны
Die Bestie	Чудовище
Unbändigkeit	Дикость
Kopfnuss	Ошеломление
Magier von Dalaran	Маг Даларана
Priesterin von Elune	Жрица Элуны
Uralter Magier	Древний маг
Meeresriese	Морской великан
Windsprecher	Говорящий с ветром
Blutritter	Рыцарь крови
Auchenaiseelenpriesterin	Аукенайская жрица
Nachtklinge	Ночной Клинок
Zerstäuben	Обращение в пар
Kultmeisterin	Глава культа
Dämonenfeuer	Демонический огонь
Wichtelmeisterin	Владычица бесов
Fieser Zuchtmeister	Злой надсмотрщик
Wütender Berserker	Разъяренный берсерк
Schildblock	Блок щитом
Innere Wut	Внутренняя ярость
Zauberlehrling	Ученица чародея
Scharfschießen	Снайперский выстрел
Sprengfalle	Взрывная ловушка
Eiskältefalle	Морозная ловушка
Magierin der Kirin Tor	Маг Кирин-Тора
Edwin van Cleef	Эдвин ван Клиф
Illidan Sturmgrimm	Иллидан Ярость Бури
Managespenst	Магический призрак
Tödlicher Schuss	Смертельный выстрел
Gleichheit	Равенство
Geschmolzener Riese	Огненный великан
Kreis der Heilung	Круг исцеления
Schattenwort: Tod	Слово Тьмы: Смерть
Vollstrecker des Tempels	Храмовый боец
Heiliges Feuer	Священный огонь
Schattengestalt	Облик Тьмы
Massenbannung	Массовое рассеивание
Zombiefraß	Вкусный зомби
Geisterhafter Krabbler	Одержимый ползун
Echoschlamm	Делящийся слизнюк
Irrer Wissenschaftler	Безумный ученый
Naxxramasschemen	Тень Наксрамаса
Nerubisches Ei	Нерубское яйцо
Spektraler Ritter	Призрачный рыцарь
Todesfürst	Владыка Смерти
Maexxna	Мексна
Netzweber	Тенетник
Schlickspucker	Изрыгатель слизи
Kel'Thuzad	Кел'Тузад
Stalagg	Сталагг
Feugen	Фойген
Klagende Seele	Стенающая душа
Netzfürst der Nerub'ar	Властелин паутины
Duplizieren	Раздвоение
Giftsamen	Ядовитые семена
Rächer	Отмщение
Biss des Todes	Укус смерти
Leerrufer	Призыватель Бездны
Dunkler Kultist	Темный сектант
Instabiler Ghul	Нестабильный вурдалак
Reinkarnation	Возрождение
Wegelagerer der Anub'ar	Неруб-душитель
Steinhautgargoyle	Каменная горгулья
Totengräber	Могильщик
Tanzende Schwerter	Танцующие клинки
Loatheb	Лотхиб
Baron Totenschwur	Барон Ривендер
Flammenkanone	Огненная пушка
Schneefresser	Снегочух
Instabiles Portal	Нестабильный портал
Goblinsprengmagier	Гоблин-взрывомаг
Echo von Medivh	Эхо Медива
Mechwarper	Механосборщик
Flammenleviathan	Огненный левиафан
Lichtbombe	Световая бомба
Schattenbomberin	Теневой бомбардир
Velens Auserwählter	Избранник Велена
Schrumpfmeister	Уменьшайстер
Licht der Naaru	Свет Наару
Ritzelmeister	Мастер шестеренок
Vol'jin	Вол'джин
Dunkelbombe	Темная бомба
Teufelshäscher	Сквернобот
Begleiter rufen	Призыв питомца
Herrin der Schmerzen	Госпожа Боли
Dämonenherz	Сердце демона
Teufelskanone	Пушка Скверны
Mal'Ganis	Мал'Ганис
Schärföl des Tüftlers	Оружейное механомасло
Goblinbarbier-o-Mat	Авто-брадобрей
Ritzelschraubenschlüssel	Гаечный ключ
Einäugiger Schwindler	Одноглазый плут
Totstellen	Притвориться мертвым
Eiserner Sensei	Железный сенсей
Handelsprinz Gallywix	Принц Галливикс
Ruf der Urahnen	Зов предков
Eloxiertes Robobärchen	Ржавый медвежонок
Wiederverwerten	Переработка
Hüterin des Hains	Хранительница рощи
Baum des Lebens	Древо Жизни
Mech-Bär-Katze	Механо-медвекот
Malorne	Малорн
Streitantriebskolben	Палица силы
Wirbelnder Zapp-o-Mat	Крутящийся меченосец
Knistern	Разряд
Totem der Vitalität	Тотем жизни
Murlocgeistwandler	Мурлок-духостранник
Dunkle Einflüsterung	Мрачный огонек
Neptulon	Нептулон
Glevehr	Метатель глеф
Spinnenpanzer	Танк-паук
Wichtelexplosion	Бес-пощадный взрыв
König der Wildtiere	Царь зверей
Sabotage	Диверсия
Metallzahnspringer	Железнозубый прыгун
Gahz'rilla	Газ'рилла
Sausendes Sägeblatt	Прыгучий сюрикэн
Kriegsbot	Боевой робот
Zermalmen	Сокрушение
Schildmaid	Защитница
Ogertotschläger	Боевой молот огров
Mörderische Rostlaube	Ржавый голем
Eiserner Koloss	Железный исполин
Siegel des Lichts	Печать Света
Abgeschirmter Minibot	Защищенный мини-бот
Zahnradhammer	Зубцевик
Rüstmeister	Интендант
Ruf zu den Waffen	Призыв в бой
Kobaltwächter	Кобальтовый страж
Bolvar Fordragon	Болвар Фордрагон
Pfützenstampfer	Грязевик
Ogerschläger	Огр-громила
Dünenbrecherschamane	Огр-шаман
Splittersteintrogg	Трогг Камнедробов
Felsenkiefertrogg	Трогг Каменной Челюсти
Antiker Heilbot	Древний исцелятор
Seebär	Просоленный моряк
Verirrter Weitschreiter	Заблудившийся долгоног
Schattenboxer	Теневой боксер
Kobraschuss	Выстрел кобры
Mystikerin von Kezan	Мистик Кезана
Schiffskanone	Корабельная пушка
Explosives Schaf	Взрывоопасная овца
Animagolem	Голем Анимуса
Mechanischer Yeti	Механический йети
Angriffspanzer MAX	Силовой танк
Druide des Giftzahns	Друид-змея
Gilblinpirscher	Жаблин-ловец
Aufziehgnom	Заводной гном
Reparaturbot 2.0	Ремонтный супербот
Flugmaschine	Ветролет
Nerv-o-Tron	Раздражатор
Belagerungsmaschine	Осадная машина
Dampfdruckschütze	Снайпер из картеля
Ninjaoger	Огр-ниндзя
Illuminatorin	Просветительница
Wahnsinniger Bomber	Ошалевший подрывник
Arkannullifizierer X-21	Чудо-обнулятор X-21
Gnomenversuchsleiter	Гном-экспериментатор
Zielattrappe	Манекен-мишень
Jeeves	Дживс
Goblinpionier	Гоблин-сапер
Bemannter Schredder	Пилотируемый крошшер
Winzige Exorzistin	Юный экзорцист
Soldat von Gnomeregan	Пехотинец Гномрегана
Bombenwerfer	Бомбометатель
Schwebender Beobachter	Парящий страж
Scharlachroter Läuterer	Освятитель Алого ордена
Tüftelstadttechniker	Гном-техник
Mikromaschine	Микроробот
Hobgoblin	Хобгоблин
Bemannter Himmelsgolem	Небесный голем
Schrottbot	Хламобот
Aufwert-o-Bot	Механо-усилитель
Rekombobulator	Рекомбинатор
Minimagier	Мини-маг
Dr. Bumm	Доктор Бум
Mimirons Kopf	Голова Мимирона
Mogor der Oger	Огр Могор
Feindschnitter 4000	Врагорез-4000
Sneeds alter Schredder	Старый крошшер Снида
Toshley	Тошли
Robogenieur Thermadraht	Анжинер Термоштепсель
Gazlowe	Газлоу
Troggzor der Erdinator	Троггзор Терранатор
Blingtron 3000	Блескотрон-3000
Hemet Nesingwary	Хеминг Эрнестуэй
Aufziehgigant	Заводной великан
Kleine Zauberblockerin	Контрзаклинательница
Rußspeier	Изрыгатель сажи
Garrosh Höllschrei	Гаррош Адский Крик
Magni Bronzebart	Магни Бронзобород
Thrall	Тралл
Morgl das Orakel	Оракул Моргл
Valeera Sanguinar	Валира Сангвинар
Maiev Schattensang	Майев Песнь Теней
Uther Lichtbringer	Утер Светоносный
Lady Liadrin	Леди Лиадрин
Prinz Arthas	Принц Артас
Rexxar	Рексар
Alleria Windläufer	Аллерия Ветрокрылая
Malfurion Sturmgrimm	Малфурион
Gul'dan	Гул'дан
Nemsy Nimmertot	Немси Некропшик
Jaina Prachtmeer	Джайна Праудмур
Medivh	Медив
Khadgar	Кадгар
Anduin Wrynn	Андуин Ринн
Tyrande Wisperwind	Тиранда Шелест Ветра
Phantomfreibeuterin	Призрачный корсар
Skelemant	Скелемант
Explosive Fledermaus	Взрывной нетопырь
Schneewatschler	Снежный прыгвин
Rasselnder Rabauke	Костяной плут
Grimmige Nekromantin	Мрачный некромант
Knochendrache	Костяной дракон
Sonnengeborene Val'kyr	Светозарная валь'кира
Kobaltblaue Bannschuppe	Кобальтовый губитель
Nachtheuler	Ночной завыватель
Giftwirkerin	Ядомант
Eingebildeter Kreuzritter	Надменный рыцарь
Lautere Beschützerin	Праведная защитница
Finsteres Urteil	Неправедный суд
Entweihen	Осквернение
Schicksalsspinnerin	Пряха Судьбы
Toxischer Pfeil	Токсичная стрела
Spinnennetz	Паутина
Druidin des Schwarms	Друид-роевик
Tot spielen	Ложная смерть
Seuchenherd	Ползучая чума
Seelendieb	Похищение души
Kryostase	Криостаз
Brrrloc	Брррлок
Bergfeuerrüstung	Пламенеющий доспех
Blutklinge	Кровавый клинок
Knochenbaron	Повелитель костей
Vryghul	Врайдалак
Eiswandler	Ледяной ходок
Grausige Beschwörerin	Жуткая кудесница
Lichtschmerz	Скорбь Света
Übler Schreckenslord	Гадкий натрезим
Lawine	Лавина
Zäher Brocken	Мертвая хватка
Drakkari-Verteidiger	Защитник драккари
Frostklon	Ледяные двойники
Todgeweihter Lehrling	Обреченная ученица
Üble Verseuchung	Тотальное заражение
Gletschermysterien	Ледяные загадки
Voodoo-Verhexerin	Проклинательница
Eisfischen	Подледная ловля
Schneegrollriese	Снежный великан
Hand des toten Mannes	Рука мертвеца
Acherus-Veteranin	Ветеран Акеруса
Tuskarrfischer	Клыкарр-рыболов
Gefallene Klerikerin	Падшая син'дорай
Schmelzofenkoloss	Тигельный колосс
Grabschrecken	Могильный громадень
Gruftlauerer	Могильный скрытень
Tickende Monstrosität	Тикающее поганище
Giftbissfalle	Ядовитая ловушка
Knochenorakel	Бросок костей
Professor Seuchenmord	Профессор Мерзоцид
Verraten und verkauft	Вероломство
Verstand rauben	Пожирание разума
Schattenaszendentin	Прислужница Тени
Akolyth der Pein	Служитель агонии
Ewige Knechtschaft	Вечное служение
Obsidianstatue	Обсидиановая статуя
Erzbischof Benedictus	Архиепископ Бенедикт
Heulbestie	Воющая тварь
Todesschuppenritter	Рыцарь Мертвожабрых
Egelgift	Похищающий жизнь яд
Waffenwurf	Умеранг
Schattenessenz	Сущность тени
Eisbrecher	Ледорез
Erweckter Berserker	Оживленный берсерк
Spuk der Runenschmiede	Рунный упырь
Leichenspinne	Трупная вдова
Schiere Verzweiflung	До последнего вздоха
Schwarzwache	Черный страж
Eisgespenst	Хладный дух
Leichenerwecker	Воскреситель мертвых
Seelenschmiede	Кузня Душ
Moorabi	Мураби
Der Lichkönig	Король-лич
Modermiene	Гниломорд
Gnomferatu	Гномферату
Val'kyr-Seelenfängerin	Похитительница душ
Grotesker Fährtenleser	Заштопанный следопыт
Haibär	Медвекула
Klagegeist des Todes	Загробный гость
Saronitzwangsarbeiter	Дренеи-каторжники
Todesverkünder	Вестница смерти
Elender Bauer	Проклятый фермер
Widerwilliges Opfer	Невольная жертва
Todesseher Thrall	Провидец смерти Тралл
Glücklicher Ghul	Веселый вурдалак
Schleichender Spuk	Крадущийся упырь
Expressbestatterin	Гробокопательница
Knochenross	Костяная кобыла
Nerubischer Zerreißer	Нерубский мастер сетей
Frostige Kommandantin	Воющий командир
Seelensog	Астральная плеть
Panzerplünderer	Крепкий мародер
Gruftlord	Владыка склепа
Seuchenforscher	Исследователь чумы
Todesaxtbestrafer	Каратель с топором
Lilian Voss	Лилиан Восс
Fleischwagen	Мясной фургон
Frostklingenchampion	Рыцарь Ледяного Клинка
Simulakrum	Симулякр
Monströser Bogenschütze	Поганый стрелок
Valeera die Bleiche	Валира Иссохшая
Todespirscher Rexxar	Ловчий смерти Рексар
Uther der Schwarzen Klinge	Утер Черный Клинок
Schattenhäscher Anduin	Темный жнец Андуин
Bluthäscher Gul'dan	Кровопийца Гул'дан
Malfurion der Befallene	Малфурион Пагубный
Frostlich Jaina	Ледяной лич Джайна
Geißelfürst Garrosh	Владыка Плети Гаррош
Hadronox	Хадронокс
Sindragosas Hauch	Дыхание Синдрагосы
Versucht es nur!	Кто на меня?!
Sindragosa	Синдрагоса
Blutkönigin Lana'thel	Королева Лана'тель
Die dunkle Seite	Темные объятия
Schattenklinge	Теневой клинок
Prinz Keleseth	Принц Келесет
Prinz Taldaram	Принц Талдарам
Prinz Valanar	Принц Валанар
Der Lichköter	Псартас
Hyldnir-Frostreiterin	Хильдская всадница
Spruchweberin	Прядильщица чар
Bolvar Feuerblut	Болвар Опаленный
Nekrotischer Spuk	Некротический упырь
Drakkari-Verzauberin	Чародейка драккари
Geistbrecher	Сокрушитель разума
Blutberauschter Elf	Кровавый гедонист
Wahnsinniges Skelett	Злобный скелет
Blutwurm	Кровавый червь
Spektrale Plünderin	Вороватый дух
Wehklagende Banshee	Голосящая банши
Leichenfledderin	Похитительница трупов
Besudelte Zelotin	Нечестивый фанатик
Katze aus dem Hut	Фокус-котус
Großmütterchen	Бабушка
Vermummte Jägerin	Скрытная охотница
Brabbelndes Buch	Болтливая книга
Nachtschreckentemplerin	Страж Ночной Погибели
Schwülstiger Mime	Напыщенный актер
Läutern	Очищение
Böse Hexendoktorin	Злая колдунья
Kara Kazham!	Сим-каражим!
Beschützt den König!	Спасай короля!
Fluch des Narren	Несчастье шута
Runenverziertes Ei	Руническое яйцо
Hausspinne	Буфетный паучок
Bücherwyrm	Книгозмей
Priester Nimmersatt	Жрец-обжора
Arkananomalie	Волшебная аномалия
Wächtereule	Пернатый страж
Grabenlauerer	Канавный скрытень
Moroes	Мороуз
Elfenbeinspringer	Белый конь
Der Kurator	Смотритель
Nethergrollhistorikerin	Историк Гнева Пустоты
Geisterklauen	Призрачные когти
Menageriewächterin	Зверовод
Piratengauner	Пират-пройдоха
Astraler Hehler	Эфириал-торговец
Portal: Mahlstrom	Портал: Водоворот
Portal: Mondlichtung	Портал: Лунная поляна
Portal: Feuerlande	Портал: Огненные Просторы
Portal: Silbermond	Портал: Луносвет
Malchezaars Wichtel	Бес Малчезара
Portal: Eisenschmiede	Портал: Стальгорн
Medivhs Kammerdiener	Лакей Медива
Tödliche Gabel	Острая вилка
Zoobot	Зообот
Prinz Malchezaar	Принц Малчезар
Medivh der Wächter	Хранитель Медив
Barnes	Барнс
Onyxläufer	Черный слон
Tafelsilbergolem	Посудный голем
Verzauberter Rabe	Колдовской ворон
Menageriemagier	Зверомаг
Arkanschmied	Волшебный кузнец
Arkanriese	Волшебный великан
Violette Illusionistin	Иллюзионистка
Vergessene Fackel	Забытый факел
Astraler Beschwörer	Кудесник-эфириал
Museumswärter	Смотритель музея
Rafaams Fluch	Проклятие Рафаама
Obsidianzerstörer	Обсидиановый крушитель
Grubenschlange	Гадюка
Reno Jackson	Рено Джексон
Gruftplünderer	Расхититель гробниц
Rumpelnder Elementar	Гремящий элементаль
Hüterin von Uldaman	Хранитель Ульдамана
Tunneltrogg	Туннельный трогг
Ausgegrabener Raptor	Ископаемый ящер
Wüstenkamel	Пустынный верблюд
Pfeilfalle	Ловушка с дротиками
Affe mit Waffe	Яростная макака
Unheimlicher Trödler	Черный археолог
Rückkehr der Verflossenen	Мурглвратности судьбы
Heilige Prüfung	Священный суд
Juwelenskarabäus	Драгоценный скарабей
Meerhexe der Naga	Морская ведьма
Gorillabot A-3	Гориллабот А-3
Riesenkröte	Огромная жаба
Gruftspinne	Могильный паук
Gesattelter Raptor	Ездовой ящер
Dschungel-Mondkin	Тропический совух
Dschinn der Zephyre	Джинн ветров
Wächter des Anubisath	Анубисат-часовой
Fossiler Teufelssaurier	Окаменелый дьявозавр
Sir Finley Mrrgglton	Сэр Финли Мрргглтон
Brann Bronzebart	Бранн Бронзобород
Elise Sternensucher	Элиза Звездочет
Beschwörungsstein	Камень призыва
Wackelige Wichte	Башня из пигмеев
Meisterdieb Rafaam	Великий вор Рафаам
Lebendig begraben	Погребение
Forscherhut	Шляпа исследователя
Unheimliche Statue	Зловещая статуя
Uralter Schemen	Древняя тень
Freigelegtes Unheil	Раскопанное зло
Famose Flossengenossen	Все у нас мррглклассно!
Rabengötze	Статуя ворона
Archäologin der Akademie	Искательница Реликвария
Verfluchte Klinge	Проклятый клинок
Belebte Rüstung	Оживленные доспехи
Miniflosse	Малый Плавник
Psychischer Schrei	Ментальный крик
Vulgärer Homunculus	Грубый гомункул
Koboldbibliothekar	Кобольд-библиотекарь
Düsterer Pakt	Темный пакт
Hakenbewehrter Häscher	Крюконосец-разоритель
Schreiter der Fal'dorei	Фал'дорайский странник
Glitzergrabscherin	Пещерная блестяшница
Koboldbarbar	Кобольд-варвар
Geringer Zauberamethyst	Оберег: малый аметист
Klingenstumpf	Длань-клинок
Baumrinde	Дубовая кожа
Eisenholzgolem	Голем из древостали
Geringer Zauberjaspis	Оберег: малая яшма
Am Scheideweg	Развилка
Astraltiger	Астральный тигр
Zerquetschende Hand	Сокрушающая длань
Koboldeinsiedler	Кобольд-отшельник
Geringer Zaubersaphir	Оберег: малый сапфир
Schmuddeliger Klobold	Обитатель стоков
Flankenangriff	Обходной удар
Höhlenhydra	Пещерная гидра
Monsterköder	Блуждающий монстр
Geringer Zaubersmaragd	Оберег: малый изумруд
Rhok'delar	Рок'делар
Trank des Heldenmuts	Зелье героизма
Geringe Zauberperle	Оберег: малая жемчужина
Auf in die Schlacht!	К оружию!
Explosive Runen	Взрывающиеся руны
Geringer Zauberrubin	Оберег: малый рубин
Wandelbare Schriftrolle	Свиток-перевертыш
Deck der Wunder	Колода чудес
Aluneth	Алунет
Skorp-o-matik	Скорпобот
Wachselementar	Восковой элементаль
Schwarzer Drachenschmied	Дракон-кузнец
Ätzender Schlick	Едкий слизнюк
Einzelkämpfer	Герой-одиночка
Steinhautbasilisk	Камнекожий василиск
Arkantyrann	Магический деспот
Grüner Glibber	Зеленое желе
Drachentöterin	Убийца драконов
Bissige Truhe	Зубастый сундук
Verschlagenes Teufelchen	Демон-проныра
Schläfriger Drache	Спящая драконица
Hortender Drache	Запасливый дракон
Katakombenkriecher	Коридорный ужас
Furbolgmoosbinder	Фурболг-мохомант
Unbekümmerte Bardin	Громкоголосый бард
Violetter Wurm	Лиловый червь
Bruchschnauzenritter	Камнерыл-рыцарь
Fleischfressender Würfel	Плотоядный куб
Sonya Schattentänzer	Соня Тенепляс
Fungumant	Грибомант
Rabenvertrauter	Ворон-фамилиар
Zorn des Drachen	Ярость дракона
Silberne Wegbereiterin	Стражница авангарда
Ruf des Zwielichts	Зов сумерек
Schimmerndes Ross	Мерцающий скакун
Geringes Zaubermithril	Оберег: малый мифрил
Von der Schippe springen	Обман смерти
Drachenseele	Душа дракона
Plötzlicher Verrat	Внезапное предательство
Elfischer Minnesänger	Эльф-менестрель
Entrinnen	Ускользание
Lynessa Sonnenleid	Линесса Печаль Солнца
Zu mir!	Ко мне!
Garstiger Brabbler	Дикий бормотун
Kerzenbogen	Свечкострел
Arkankonstrukteur	Магический бронник
Verfluchter Jünger	Проклятый ученик
Düstermaulwurf	Жуткий крот
Unidentifiziertes Elixier	Неопознанный эликсир
Unidentifizierter Schild	Неопознанный щит
Unidentifizierter Hammer	Неопознанный молот
Pilzbrauer	Грибовар
Besessener Lakai	Одержимый лакей
Eichenranken	Зов чащобы
Kristalllöwe	Хрустальный лев
Bärbeißiger Wächter	Косолапый страж
Pilzversessener Trogg	Трогг-мрачноед
Pilzfürst Ixlid	Архигриб Икслид
Stufenaufstieg!	Новый уровень!
Primitive Talismane	Талисманы стихий
Koboldlehrling	Кобольд-адепт
Gieriger Waldgeist	Жадный дух
Psionischer Blick	Псионный зонд
Marin der Fuchs	Марин Лис
Groll der Weltenrüttler	Грамбл, сотрясатель миров
Staubwindkerkermeister	Кобольд-тюремщик
Rundumschlag	Шквал гнева
Juwelenbesetzter Golem	Инкрустированный голем
Trockenstoppelschmied	Сухоус-бронник
Leerenfürst	Повелитель Бездны
Gruppensuche	Всей группой!
Heilender Regen	Целительный ливень
Gildenrekrutiererin	Вербовщица гильдии
Unheilsbringer	Бедоруб
Koboldmönch	Кобольд-монах
Hungriger Ettin	Голодный эттин
Fungusverzauberer	Гриб-чародел
Stöbernder Kobold	Кобольд-барахольщик
Zweig des Weltenbaums	Ветвь Древа Жизни
Schreischwammerl	Визжащий гриб
Wohlwollender Dschinn	Великодушный джинн
Zwielichtbrecher	Вестник заката
Koboldillusionist	Кобольд-иллюзионист
Panzerkäfer	Бронированный жук
Großarchivar	Великий архивариус
Erste Jüngerin Rin	Первоученица Рин
Kataklysmus	Катаклизм
Schädel der Man'ari	Череп Ман'ари
Val'anyr	Вал'анир
Geringer Zauberonyx	Оберег: малый оникс
Instabile Evolution	Изменчивая эволюция
Der Runenspeer	Рунное копье
Geringer Zauberdiamant	Оберег: малый алмаз
Kathrena Winterleuchten	Катрена Зимний Шорох
Zola die Gorgone	Зола Горгона
Brausender Elementar	Рокочущий элементаль
Scherwindsturmrufer	Ветрорез-призыватель
Geoformerin Yip	Геоскульптор Йип
Sickernder Schleimling	Журчащий слизнюченыш
Meister Eichenherz	Мастер Сердцедуб
Die Wände kommen näher!	Сокрушающие стены
Die Dunkelheit	Тьма
Zwielichtakolyth	Сумеречный послушник
Leerenreißer	Потрошитель Бездны
Goldener Gargoyle	Золоченая горгулья
Drachenruferin Alanna	Дракономант Аланна
Leylinienmanipulator	Элементаль-манипулятор
Temporus	Темпорус
Boshafte Beschwörerin	Злая призывательница
Drachenbrutwächter	Драконозаводчик
König Togwaggel	Король Вихлепых
Königsbann	Погибель королей
Opferpakt	Жертвенный договор
Verschwinden	Исчезновение
Entführer	Похититель
Sternenregen	Звездопад
Urtum der Lehren	Древо мудрости
Al'Akir der Windlord	Ал'акир
Elitesoldat der Kor'kron	Кор'кронский воин
Manawyrm	Маназмей
Meisterin der Tarnung	Мастер маскировки
Papagei des Kapitäns	Попугай капитана
Hungrige Krabbe	Голодный краб
Blutsegelräuberin	Дерзкая налетчица
Messerjongleur	Жонглер кинжалами
Wilder Pyromant	Яростный пиромант
Untergangsverkünder	Вестник рока
Schreckenskorsar	Жуткий корсар
Feendrache	Чудесный дракончик
Kapitän Grünhaut	Капитан Зеленямс
Blutsegelkorsar	Кровожадный корсар
Violette Ausbilderin	Учительница магии
Südmeerkapitän	Капитан Южных морей
Millhaus Manasturm	Миллхаус Манашторм
Todesschwinge	Смертокрыл
Tierbegleiter	Питомец
Befehlsruf	Командирский крик
Meisterschwertschmied	Мастер ковки клинков
Gruul	Груул
Hogger	Дробитель
Panischer Kodo	Несущийся кодо
Murlocinquisitor	Мурквизитор
Urtümliche Fusion	Сила стихий
Gesichtsloser Pyromane	Пламенный безликий
Ewiger Wächter	Вечный страж
Evolution	Эволюция
Ding aus der Tiefe	Нечто из глубин
Der Schattenhammer	Молот Сумерек
Tentakel statt Arme	Цепкие щупальца
Silithidschwärmer	Силитид-членистоног
Y'Shaarj, Unbändige Wut	И'Шарадж
Fandral Hirschhaupt	Фэндрал Олений Шлем
Verseuchen	Заражение
Wilde Wut	Звериное неистовство
Y'Shaarjs Mal	Метка И'Шараджа
Verbotenes Urtum	Запретное древо
Auf der Jagd	Охота
Klingenkultist	Сектант-убийца
Reise in die Tiefe	Путь через глубины
Disteltee	Скорополоховый чай
Xaril, Vergifteter Geist	Ксарил
Zertrümmern	Раскол
Mutierter Kobold	Мутировавший кобольд
Zwielichtflammenrufer	Сумеречный пиромант
Wahnsinniger Frostrufer	Безумный служитель льда
Verbotene Flamme	Запретное пламя
Diener von Yogg-Saron	Слуга Йогг-Сарона
Kabalistenfoliant	Фолиант заговорщика
Machtwort: Tentakel	Слово силы: Щупальца
Zwielichtdunkelheilerin	Сумеречная целительница
Schattenwort: Schrecken	Слово Тьмы: Ужас
Verbotene Schöpfung	Запретная форма
Dunkelsprecher	Темный проповедник
Schattenhingabe	Объятия Тьмы
Dunkelhain-Gelehrte	Библиотекарь Темнолесья
Dunkelhain-Ratsherr	Член совета Темнолесья
Verbotenes Ritual	Запретный ритуал
Grassierender Wahn	Заразительное безумие
Abkehr von der Dunkelheit	Отречение от Тьмы
Anomalus	Аномалус
Cho'gall	Чо'Галл
Mukla, Tyrann des Tals	Мукла, Гроза Долины
Gestaltwandler Zerus	Оборотень Зерус
Imperator Vek'lor	Император Век'лор
N'Zoth, der Verderber	Н'Зот
Yogg-Saron, Hoffnungsende	Йогг-Сарон
Nerubischer Prophet	Нерубский пророк
Gesichtsloses Ungetüm	Безликий гигант
Unheimlicher Schrecken	Зловещий ужас
Psych-o-Tron	Психонатор
Verderbter Heilbot	Оскверненный исцелятор
Zerstörerischer Ghul	Буйный вурдалак
Entstellter Berserker	Искаженный берсерк
Tentakel von N'Zoth	Щупальце Н'Зота
Grotesker Drachenfalke	Уродливый дракондор
Moorschleicher	Болотный ползун
Gallflossengezeitenjäger	Порочный волнолов
Eifriger Initiand	Ревностный аколит
Verderbter Seher	Падший провидец
Jünger von C'Thun	Поборник К'Туна
Blut des Uralten	Кровь Древнего
Gesichtsloser Schlurfer	Безликий шаркун
Schattenschlag	Теневой удар
Feurige Fledermaus	Огненный нетопырь
Bernweber der Klaxxi	Прядильщик клакси
Verderbte Irrwische	Древние огоньки
Verbotene Heilung	Запретное исцеление
Triumphierender Verkünder	Вестник доказанного рока
Hüter des Morasts	Хранитель болот
Donnerkrachen	Удар молнии
Gesichtsloser Beschwörer	Безликий призыватель
Hallazeal der Aufgestiegene	Халлазил Перерожденный
Ruf der Wildnis	Зов лесов
Befallener Wolf	Зараженный волк
Kriegerheld der Bluthufe	Храбрец Кровавого Копыта
Malkorok	Малкорок
Selbstlose Heldin	Самоотверженная героиня
Klinge des Ansporns	Объединяющий клинок
Göttliche Stärke	Божественная сила
Ragnaros der Lichtfürst	Рагнарос Слуга Света
Dunkelhain-Alchemistin	Алхимик Темнолесья
VERDAMMNIS!	Погибель!
Besessener Dorfbewohner	Одержимый крестьянин
Mutierter Worgen	Искаженный ворген
Am'gam-Wüter	Яростень Ам'гам
Infizierter Tauren	Зараженный таурен
Geheimniszehrer	Пожиратель секретов
Verdammnisrufer	Призыватель Рока
Brut von N'Zoth	Порождение Н'Зота
Südmeer-Tentakelbart	Кальмарный пират
Geschuppter Alptraum	Чешуйчатый кошмар
Zwielichtbeschwörer	Сумеречный призыватель
Vereint gegen das Dunkel	Преграда на пути Тьмы
Blutkrieger	Кровавые воины
C'Thun	К'Тун
Beschwörerin des Bösen	Зовущая Зло
Klinge von C'Thun	Клинок К'Туна
C'Thuns Auserwählte	Избранница К'Туна
Zwielichtgeomantin	Сумеречный геомант
Zwielichtältester	Сумеречный предок
Uralte Vorbotin	Древняя предвестница
Schattenwirkerin	Темная чародейка
Einsamer Pirscher	Одинокий охотник
Dunkler Arakkoa	Темный араккоа
Apotheker des Kults	Аптекарь-сектант
Der Alptraumschlinger	Букамонстр
Uralte Schildträgerin	Древний щитоносец
Seelenführerin	Привратница душ
Zauberin des Kults	Колдунья-сектантка
Riesiger Sandwurm	Огромный песчаный червь
Prinzessin Huhuran	Принцесса Хухуран
Dunkelhain-Statthalterin	Распорядитель Темнолесья
Licht in der Dunkelheit	Свет во Тьме
N'Zoths Erster Maat	Первый помощник Н'Зота
Gestörter Grizzly	Обезумевший гризли
Blut zu Sekret	Кровь и гной
Blutsegelkultistin	Пират-сектантка
Herold Volazj	Глашатай Волаж
Drachenlord Todesschwinge	Владыка Смертокрыл
Hogger, Geißel von Elwynn	Кошмарный Дробитель
Mitternachtsdrache	Полночный дракон
Wahnsinniger Anbeter	Безумный служитель
Schwarzmeerpiratin	Пират Черноводья
Verseuchter Hamsterer	Грязный барахольщик
Aaslarve	Личинка-падальщик
Düstereber	Темный вепрь
Zuckendes Tentakel	Извивающееся щупальце
Meister der Evolution	Мастер эволюции
Hehler aus Unterstadt	Торговец из Подгорода
Okkulte Akolythin	Скрытная послушница
Flüchtiger Schemen	Изменчивая тень
Schreckenszyklop	Одноглазый ужас
Nat der Dunkelfischer	Нат, Темный Рыболов
Kultist von Skeram	Сектант Скерама
Soggoth der Glitschige	Соггот
Elite Tauren Chieftain	E.T.C.
Fleischfressender Ghul	Плотоядный вурдалак
Zauberformerin	Чароплет
Pterrordaxjunges	Птенец терродактиля
Vulkanosaurus	Вулканозавр
Dinogröße	Динозаврение
Mickriger Ravasaurus	Малыш-равазавр
Gesättigter Dreschadon	Сытый жесткозуб
Hydrologin	Гидролог
Sonnenhüter Tarim	Хранитель Солнца Тарим
Flammengeysir	Огненный гейзер
Luftelementar	Элементаль воздуха
Arkanologin	Арканолог
Dampfwoger	Паровая туча
Illusionsbeschwörer	Призыватель миражей
Manabindung	Узы маны
Vulkan	Вулкан
Pyros	Пирос
Öffnet das Portal	Связующая спираль
Schattenvisionen	Темные видения
Verbindende Heilung	Связующее исцеление
Kristallorakel	Кристаллический оракул
Strahlender Elementar	Сияющий элементаль
Seltsame Leuchtwurzel	Чудной сверкорень
Tortollanerpriesterin	Тортолльская стражница
Hungriger Pterrordax	Ненасытный терродактиль
Teerlauerer	Смоляной скрытень
Klingenblütensalve	Шквал остроцветов
Klingenblütenpeitscher	Колкий остроцвет
Klonkapsel	Мимикрия
Obsidiansplitter	Обсидиановый осколок
Fresswurz	Кусачник
Mörderorchidee	Кровожадный злолист
Sherazin die Aasblume	Шеразин
Abstieg in die Tiefe	Подземные пещеры
Steinformer der Tol'vir	Тол'вирский камнемаг
Riesenmastodon	Огромный мастодонт
Steinhöhenverteidiger	Защитник холмов
Steinteichjäger	Озерный охотник
Bösartiges Jungtier	Коварный птенец
Eierdieb	Яйцекрад
Tortollanersammlerin	Тортолльская сборщица
Frostkoloss	Ледяной сокрушитель
Donnerechse	Рокочущий ящер
Teufelssaurierei	Яйцо дьявозавра
Feuersäulenphönix	Феникс Огненного Венца
Smaragdschwarmkönigin	Изумрудная королева
Riesenanakonda	Огромная анаконда
Bittertidenhydra	Гидра Горьких Волн
Tortollanerprimalistin	Тортолльская шаманка
Gutmütiger Megasaurus	Кроткий мегазавр
Geladener Teufelssaurier	Заряженный дьявозавр
Bewachsener Langhals	Зеленое длинношеее
Echsenwandler	Перевертыш
Mutierende Sporen	Споры роста
Irdene Schuppen	Земляная чешуя
Urlanghals	Древнее длинношеее
Lebendiges Mana	Живая мана
Enthusiastische Späherin	Зоркая разведчица
Riesen des Urwalds	Исполины джунглей
Totem der Urflossen	Тотем палеомурлоков
Vorbote der Feuersäule	Вестник Огненного Венца
Gletschersplitter	Ледниковый осколок
Steinwächter	Каменный часовой
Kalimos, Herr der Urzeit	Калимос Первородный
Schreckensschuppenjäger	Ловчий злобноплав
Nistender Roc	Рух-наседка
Smaragdhäscher	Изумрудный разоритель
Ultrasaurus	Ультразавр
Golakkakrabbler	Ползун Голакка
Sture Urschnecke	Упрямый брюхоног
Feuerteufelchen	Огневичок
Stegodon	Стегодон
Säbelzahnpirscher	Хищный саблезуб
Sturmseher	Страж бурь
Riesenwespe	Гигантская оса
Diener von Kalimos	Слуга Калимоса
Gezeitenwoge	Гнев прилива
Instabiler Elementar	Нестабильный элементаль
Waffe vergiften	Отравленное оружие
Opfer von Lakkari	Жертва Лаккари
Grausame Dinomantin	Жестокий диномант
Verderbender Nebel	Пелена порчи
Blutblüte	Кроволист
Teufelshund von Lakkari	Гончая Лаккари
Fütterungszeit	Налетай!
Zirpender Tunnelgräber	Стрекочущий землерой
Gelegemutter Zavas	Королева Завас
Teerfürst	Смоляной дух
Hemet der Dschungeljäger	Охотник Хеминг
Der Voraxx	Воракс
Kolossales Klingenblatt	Исполинский бритволист
Vulkanelementar	Пылкий элементаль
Flackernder Sturm	Проблеск бури
Glutbringer	Вестник зарева
Urzeitlicher Drache	Доисторический дракон
Elise die Entdeckerin	Первопроходец Элиза
Tyrantus	Тирантий
In Bernstein gefangen	Нечто из янтаря
Halluzination	Иллюзия
Geistersängerin Umbra	Волхвица Умбра
Ozruk	Озрук
Schrecklicher Biss	Болезненный укус
Juwelenara	Самоцветный ара
Wächter der Tol'vir	Тол'вирский часовой
Raptorjunges	Детеныш ящера
Knisternder Scharfzahn	Искрящий острозуб
Stampede	Дикий гон
Dinomantie	Диномантия
Sumpfkönig Dred	Король болот Дред
Die Morastkönigin	Королева болот
Erkundet Un'Goro	Изучение Ун'Горо
Eisenhaut	Железная шкура
Reizbares Terrorhorn	Злой дикорог
Umzingelte Wächterin	Разведчица в беде
Spontangenese	Внезапногенез
Teerkriecher	Смоляной страж
Geschmolzene Klinge	Клинок из лавы
König Mosh	Король Мош
Das Herz der Feuersäule	Сердце Огненного Венца
Späher der Urflossen	Палеомурлок-разведчик
Thermalquellenwächter	Страж гейзера
Erweckt die Schöpfer	Пробуждение творцов
Glyphe der Urzeit	Петроглиф
Vereint die Murlocs	Мурлочий союз
Gefräßiger Schlamm	Прожорливая слизь
Geschmolzenes Ebenbild	Копия из лавы
Rankenrichter	Лозоруб
Stachelbewehrtes Reittier	Гребнистый скакун
Krieger der Urflossen	Палеомурлок-защитник
Der letzte Kaleidosaurier	Последний калейдозавр
Meteor	Метеорит
Geisterecho	Отголоски духов
Terrorhornjunges	Детеныш дикорога
Grüne Hölle	Заблудившиеся в джунглях
Mutation	Адаптация
Lichtgeladener Stegodon	Сияющий стегодон
Lyra die Lichtbrecherin	Лира Осколок Солнца
