Flame Lance	Огненное копье
Effigy	Чучело
Fallen Hero	Павший герой
Arcane Blast	Чародейская вспышка
Polymorph: Boar	Превращение в вепря
Dalaran Aspirant	Боец из Даларана
Spellslinger	Чаромет
Coldarra Drake	Дракон Хладарры
Rhonin	Ронин
Ram Wrangler	Пастух
Holy Champion	Святая защитница
Spawn of Shadows	Исчадие теней
Power Word: Glory	Слово силы: Слава
Shadowfiend	Исчадие Тьмы
Convert	Обращение
Confuse	Замешательство
Twilight Guardian	Сумеречный страж
Confessor Paletress	Исповедница Пейлтресс
Dreadsteed	Конь погибели
Fearsome Doomguard	Грозный демон
Tiny Knight of Evil	Малый рыцарь зла
Fist of Jaraxxus	Кулак Джараксуса
Void Crusher	Крушитель из Бездны
Demonfuse	Демоническая сила
Dark Bargain	Темная сделка
Wrathguard	Страж гнева
Wilfred Fizzlebang	Вилфред Непопамс
Shado-Pan Rider	Всадник Шадо-Пан
Buccaneer	Буканьер
Undercity Valiant	Рыцарь Подгорода
Cutpurse	Карманник
Shady Dealer	Сомнительный делец
Burgle	Воришка
Poisoned Blade	Отравленное лезвие
Beneath the Grounds	Из-под земли
Anub'arak	Ануб'арак
Living Roots	Живые корни
Darnassus Aspirant	Боец из Дарнаса
Savage Combatant	Яростный воин
Wildwalker	Дикая странница
Knight of the Wild	Рыцарь чащи
Druid of the Saber	Друид-саблезуб
Astral Communion	Астральное единение
Mulch	Мульчирование
Aviana	Авиана
Tuskarr Totemic	Клыкарр-шаман
Draenei Totemcarver	Резчица тотемов
Healing Wave	Волна исцеления
Thunder Bluff Valiant	Рыцарь Громового Утеса
Charged Hammer	Магический молот
Elemental Destruction	Разрушительные стихии
Totem Golem	Тотемный голем
Ancestral Knowledge	Древнее знание
The Mistcaller	Призыватель туманов
Flash Heal	Быстрое исцеление
Powershot	Мощный выстрел
Stablemaster	Главный конюх
King's Elekk	Королевский элекк
Brave Archer	Храбрая лучница
Bear Trap	Медвежья ловушка
Lock and Load	На изготовку!
Ball of Spiders	Паучий клубок
Acidmaw	Кислотная Утроба
Dreadscale	Жуткая Чешуя
Bash	Оглушить
King's Defender	Королевский поборник
Orgrimmar Aspirant	Боец из Оргриммара
Magnataur Alpha	Вожак магнатавров
Bolster	Усиление
Sparring Partner	Спарринг-партнер
Skycap'n Kragg	Крагг Поднебесный
Alexstrasza's Champion	Защитница Алекстразы
Varian Wrynn	Вариан Ринн
Competitive Spirit	Боевой настрой
Seal of Champions	Печать чемпионов
Warhorse Trainer	Боевой берейтор
Murloc Knight	Мурлок-рыцарь
Argent Lance	Серебряное копье
Enter the Coliseum	Вход в Колизей
Mysterious Challenger	Загадочный претендент
Garrison Commander	Командир гарнизона
Eadric the Pure	Эдрик Чистый
Lowly Squire	Скромный оруженосец
Dragonhawk Rider	Всадник на дракондоре
Lance Carrier	Копьеносец
Maiden of the Lake	Озерная дева
Saboteur	Саботажник
Argent Horserider	Серебряный всадник
Mogor's Champion	Защитник Могора
Boneguard Lieutenant	Костяной лейтенант
Mukla's Champion	Защитник Муклы
Tournament Medic	Лекарь турнира
Ice Rager	Ледяной яростень
Frigid Snobold	Морозный снобольд
Flame Juggler	Жонглер пламенем
Silent Knight	Молчаливый рыцарь
Clockwork Knight	Заводной рыцарь
Tournament Attendee	Зритель турнира
Sideshow Spelleater	Глотательница чар
Kodorider	Всадница на кодо
Silver Hand Regent	Паладин-регент
Pit Fighter	Боец арены
Captured Jormungar	Пленный йормунгар
North Sea Kraken	Кракен Северного моря
Tuskarr Jouster	Бретер-клыкарр
Injured Kvaldir	Раненый квалдир
Light's Champion	Защитник Света
Armored Warhorse	Бронированный скакун
Argent Watchman	Серебряный дозорный
Coliseum Manager	Распорядитель Колизея
Refreshment Vendor	Продавец закусок
Master Jouster	Великий бретер
Recruiter	Вербовщик
Evil Heckler	Злобный насмешник
Fencing Coach	Учитель фехтования
Wyrmrest Agent	Драконий посланник
Master of Ceremonies	Церемониймейстер
Grand Crusader	Великий рыцарь
Kvaldir Raider	Квалдир-налетчик
Frost Giant	Ледяной великан
Crowd Favorite	Кумир толпы
Gormok the Impaler	Гормок
Chillmaw	Ледяная Пасть
Bolf Ramshield	Болф Таранный Щит
Icehowl	Ледяной Рев
Nexus-Champion Saraad	Сараад, рыцарь Нексуса
The Skeleton Knight	Рыцарь-скелет
Fjola Lightbane	Фьола Погибель Света
Sea Reaver	Гроза морей
Eydis Darkbane	Эйдис Погибель Тьмы
Justicar Trueheart	Мариэль Чистосердечная
Gadgetzan Jouster	Бретер из Прибамбасска
Solemn Vigil	Священное бдение
Flamewaker	Поджигатель
Dragon's Breath	Дыхание дракона
Twilight Whelp	Сумеречный дракончик
Demonwrath	Демонический гнев
Imp Gang Boss	Главарь банды бесов
Gang Up	Сходка
Dark Iron Skulker	Тихоступ Черного Железа
Volcanic Lumberer	Вулканический древень
Druid of the Flame	Друид пламени
Lava Shock	Лавовый шок
Fireguard Destroyer	Огнестраж-разрушитель
Quick Shot	Скорострельность
Core Rager	Яростень Недр
Revenge	Возмездие
Axe Flinger	Метатель топоров
Resurrect	Воскрешение
Dragon Consort	Супруга дракона
Grim Patron	Мрачный завсегдатай
Dragonkin Sorcerer	Драконор-чародей
Dragon Egg	Яйцо дракона
Drakonid Crusher	Драконид-сокрушитель
Volcanic Drake	Вулканический дракон
Hungry Dragon	Голодный дракон
Majordomo Executus	Мажордом Экзекутус
Emperor Thaurissan	Император Тауриссан
Rend Blackhand	Ренд Чернорук
Nefarian	Нефариан
Chromaggus	Хромаггус
Blackwing Technician	Техник Крыла Тьмы
Blackwing Corruptor	Губитель Крыла Тьмы
Raza the Chained	Раза Плененный
Freezing Potion	Зелье заморозки
Wind-up Burglebot	Заводной воробот
Hidden Cache	Схрон
Street Trickster	Уличный фокусник
Red Mana Wyrm	Алый маназмей
Jinyu Waterspeaker	Говорящий с водой
Grimestreet Protector	Защитник трущоб
Kooky Chemist	Чокнутый химик
Blubber Baron	Толстосум
Volcanic Potion	Вулканическое зелье
Kabal Lackey	Прихвостень «Кабала»
Hozen Healer	Хозен-лекарь
Felfire Potion	Зелье огня Скверны
Weasel Tunneler	Пронырливая ласка
Mistress of Mixtures	Мастерица микстур
Public Defender	Адвокат
Smuggler's Run	Незаконный ввоз
Kun the Forgotten King	Кун, Забытый Король
Call in the Finishers	Мурлоковороты
Jade Chieftain	Нефритовый вождь
Finders Keepers	Было ваше, стало наше!
Alleycat	Бродячий кот
Rat Pack	Крысиная стая
Grimestreet Informant	Осведомитель из трущоб
White Eyes	Млечноокий
Small-Time Buccaneer	Мелкий буканьер
Fight Promoter	Организатор боев
Knuckles	Кулакс
Smuggler's Crate	Контрабандный товар
Dispatch Kodo	Патрульный кодо
Shaky Zipgunner	Самопальщик
Piranha Launcher	Пиранострел
Trogg Beastrager	Трогг-погонщик
Sergeant Sally	Сержант Салли
Luckydo Buccaneer	Удачливый буканьер
Jade Behemoth	Нефритовое чудище
Finja, the Flying Star	Мурлиндзя
Jade Idol	Нефритовый идол
Potion of Madness	Зелье безумия
Greater Healing Potion	Среднее лечебное зелье
Drakonid Operative	Драконид-шпион
Mana Geode	Мановая жеода
Blastcrystal Potion	Зелье взрыв-кристалла
Fel Orc Soulfiend	Душегуб Скверны
Crystalweaver	Заклинатель кристаллов
Bloodfury Potion	Зелье кровавой ярости
Mark of the Lotus	Знак «Лотоса»
Pilfered Power	Кража силы
Celestial Dreamer	Небесная провидица
Kabal Chemist	Химик «Кабала»
Potion of Polymorph	Зелье превращения
Kazakus	Казакус
Greater Arcane Missiles	Чародейские суперстрелы
Kabal Talonpriest	Жрец Когтя из «Кабала»
Counterfeit Coin	Фальшивая монетка
Brass Knuckles	Латунный кастет
Lotus Assassin	Убийца из «Лотоса»
Shadow Rager	Яростень Тьмы
Patches the Pirate	Пират Глазастик
Grimestreet Enforcer	Громила из трущоб
Hobart Grapplehammer	Хобарт Дрек
Backstreet Leper	Лепрогном из подворотни
Blowgill Sniper	Снайпер Свистожабрых
Big-Time Racketeer	Матерый гангстер
Kabal Courier	Курьер «Кабала»
Grimscale Chum	Живец Темной Чешуи
Naga Corsair	Нага-корсар
Second-Rate Bruiser	Второсортный костолом
Hired Gun	Наемник
Friendly Bartender	Радушный трактирщик
Toxic Sewer Ooze	Токсичный слизнюк
Streetwise Investigator	Уличный детектив
Kabal Songstealer	Песнекрад «Кабала»
Backroom Bouncer	Вышибала
Gadgetzan Socialite	Светская львица
Manic Soulcaster	Заклинательница душ
Pint-Size Potion	Гномозелье
Dragonfire Potion	Зелье драконьего огня
Kabal Trafficker	Перевозчица «Кабала»
Worgen Greaser	Ворген-стиляга
Grook Fu Master	Мастер грук-фу
Bomb Squad	Подрывница
Doppelgangster	Доппельгангстер
Burgly Bully	Вороватый задира
Mayor Noggenfogger	Мэр Гогельмогель
Cryomancer	Криомантка
Madam Goya	Мадам Гойя
Don Han'Cho	Дон Хан'Чо
Inkmaster Solia	Каллиграф Солия
Spiked Hogrider	Шипастый хряк
Jade Shuriken	Нефритовый сюрикэн
Jade Swarmer	Нефритовый роевик
Gadgetzan Ferryman	Паромщик
Shadow Sensei	Сенсей Тьмы
Devolve	Инволюция
Lotus Illusionist	Иллюзионистка «Лотоса»
Seadevil Stinger	Морской дьявол
Jade Lightning	Нефритовая молния
Jade Blossom	Нефритовый цветок
Jade Spirit	Нефритовый дух
Sleep with the Fishes	На корм рыбам
Jade Claws	Нефритовые когти
Krul the Unshackled	Крул Освобожденный
Abyssal Enforcer	Могучий абиссал
Stolen Goods	Чужое добро
Grimestreet Outfitter	Торговец из трущоб
Grimy Gadgeteer	«Бугай»-технарь
Grimestreet Pawnbroker	Ростовщица из трущоб
Alley Armorsmith	Уличная бронница
Meanstreet Marshal	Страж порядка
Kabal Crystal Runner	Разносчица кристаллов
Shaku, the Collector	Шаку Собиратель
Dirty Rat	Грязная крыса
Getaway Kodo	Побег на кодо
Wrathion	Гневион
Auctionmaster Beardo	Аукционист Вихлюн
Genzo, the Shark	Шулер Гензо
Tanaris Hogchopper	Турбохряк из Танариса
Leatherclad Hogleader	Главарь «Ночных хряков»
Lunar Visions	Лунные видения
Wickerflame Burnbristle	Сенопал Огнеус
Virmen Sensei	Гну-синь-сенсей
Daring Reporter	Бесстрашный репортер
Lotus Agents	Агенты «Лотоса»
Grimestreet Smuggler	Контрабандистка
Ancient of Blossoms	Древо цветения
Defias Cleaner	Ликвидатор из Братства
Unlicensed Apothecary	Подпольный аптекарь
Aya Blackpaw	Айя Черная Лапа
Small-Time Recruits	Мелкие сошки
I Know a Guy	Я знаю кое-кого
Goldshire Footman	Солдат Златоземья
Fen Creeper	Трясинный ползун
Holy Nova	Кольцо света
Mind Control	Контроль разума
Inner Fire	Внутренний огонь
Holy Smite	Божественная кара
Mind Vision	Внутреннее зрение
Power Word: Shield	Слово силы: Щит
Claw	Коготь
Healing Touch	Целебное касание
Moonfire	Лунный огонь
Mark of the Wild	Знак дикой природы
Savage Roar	Дикий рев
Swipe	Размах
Wild Growth	Буйный рост
Polymorph	Превращение
Arcane Intellect	Интеллект чародея
Frostbolt	Ледяная стрела
Arcane Explosion	Чародейский взрыв
Frost Nova	Кольцо льда
Mirror Image	Зеркальные копии
Blizzard	Снежная буря
Fireball	Огненный шар
Ice Lance	Ледяное копье
Flamestrike	Волна огня
Water Elemental	Элементаль воды
Frost Shock	Ледяной шок
Ancestral Spirit	Дух предков
Windfury	Неистовство ветра
Ancestral Healing	Исцеление предков
Fire Elemental	Элементаль огня
Rockbiter Weapon	Камнедробитель
Bloodlust	Жажда крови
Far Sight	Дальнее зрение
Shadow Bolt	Стрела Тьмы
Blood Imp	Кровавый бес
Drain Life	Похищение жизни
Hellfire	Адское пламя
Corruption	Порча
Dread Infernal	Жуткий инфернал
Voidwalker	Демон Бездны
Backstab	Удар в спину
Cold Blood	Хладнокровие
Deadly Poison	Смертоносный яд
Sinister Strike	Коварный удар
Assassinate	Ликвидация
Sprint	Спринт
Assassin's Blade	Клинок убийцы
Hunter's Mark	Метка охотника
Blessing of Might	Печать могущества
Guardian of Kings	Защитник королей
Holy Light	Свет небес
Light's Justice	Правосудие Света
Blessing of Kings	Печать королей
Consecration	Освящение
Hammer of Wrath	Молот гнева
Truesilver Champion	Серебряный клинок
Charge	Рывок
Rampage	Буйство
Heroic Strike	Удар героя
Fiery War Axe	Огненная секира
Execute	Казнь
Arcanite Reaper	Арканитовый жнец
Cleave	Рассекающий удар
Earthen Ring Farseer	Служитель Земли
Magma Rager	Магмовый яростень
Oasis Snapjaw	Оазисный хрустогрыз
River Crocolisk	Речной кроколиск
Frostwolf Grunt	Боец Северного Волка
Raid Leader	Лидер рейда
Wolfrider	Всадник на волке
Ironfur Grizzly	Гризли-сталемех
Silverback Patriarch	Седоспин-патриарх
Stormwind Knight	Рыцарь Штормграда
Ironforge Rifleman	Ружейник Стальгорна
Kobold Geomancer	Кобольд-геомант
Southsea Deckhand	Матрос Южных морей
Gnomish Inventor	Гном-изобретатель
Stormpike Commando	Дворф-диверсант
Silver Hand Knight	Рыцарь Длани
Archmage	Верховный маг
Ravenholdt Assassin	Скрытный убийца
Lord of the Arena	Повелитель арены
Murloc Raider	Мурлок-налетчик
Young Dragonhawk	Молодой дракондор
Stonetusk Boar	Вепрь-камнеклык
Bloodfen Raptor	Ящер Кровавой Топи
Bluegill Warrior	Воин Синежабрых
Sen'jin Shieldmasta	Щитоносец Сен'джин
Injured Blademaster	Раненый рубака
Chillwind Yeti	Морозный йети
War Golem	Боевой голем
Booty Bay Bodyguard	Гоблин-телохранитель
Abusive Sergeant	Бранящийся сержант
Elven Archer	Эльфийская лучница
Razorfen Hunter	Охотница на Иглошкурых
Ogre Magi	Огр-маг
Boulderfist Ogre	Огр Тяжелого Кулака
Core Hound	Гончая Недр
Ironbeak Owl	Железноклюв
Reckless Rocketeer	Шальная ракетчица
Spiteful Smith	Зловещий кузнец
Stormwind Champion	Герой Штормграда
Frostwolf Warlord	Вождь Северного Волка
Venture Co. Mercenary	Алчный наемник
Wisp	Огонек
Ironbark Protector	Сторожевое древо
Blade Flurry	Шквал клинков
Shadow Word: Pain	Слово Тьмы: Боль
Northshire Cleric	Клирик Североземья
Divine Spirit	Божественный дух
Starving Buzzard	Голодный канюк
Darkscale Healer	Нага-целительница
Houndmaster	Псарь
Timber Wolf	Лесной волк
Tundra Rhino	Тундровый люторог
Multi-Shot	Залп
Tracking	Выслеживание
Arcane Shot	Чародейский выстрел
Gladiator's Longbow	Длинный лук
Mind Blast	Взрыв разума
Lightwarden	Стражница Света
The Black Knight	Черный рыцарь
Young Priestess	Молодая жрица
Big Game Hunter	Опытный охотник
Alarm-o-Bot	Тревого-бот
Acolyte of Pain	Служитель боли
Argent Squire	Сквайр Авангарда
Angry Chicken	Злая курица
Worgen Infiltrator	Ворген-разведчик
Voodoo Doctor	Знахарь вуду
Bloodmage Thalnos	Маг крови Талнос
King Mukla	Король Мукла
Novice Engineer	Инженер-новичок
Sylvanas Windrunner	Сильвана Ветрокрылая
Jungle Panther	Тропическая пантера
Shattered Sun Cleric	Священник син'дорай
Scarlet Crusader	Алый крестоносец
Thrallmar Farseer	Провидец Траллмара
Silvermoon Guardian	Страж Луносвета
Dragonling Mechanic	Дракономеханик
Stranglethorn Tiger	Тигр Тернистой долины
Leper Gnome	Лепрогном
Sunwalker	Служительница солнца
Windfury Harpy	Неистовая гарпия
Twilight Drake	Сумеречный дракон
Questing Adventurer	Авантюрист
Ancient Watcher	Древний дозорный
Dark Iron Dwarf	Дворф Черного Железа
Spellbreaker	Разрушитель чар
Youthful Brewmaster	Молодой хмелевар
Coldlight Oracle	Вайш'ирский оракул
Mana Addict	Любительница маны
Ancient Brewmaster	Старый хмелевар
Sunfury Protector	Заступница син'дорай
Crazed Alchemist	Безумный алхимик
Old Murk-Eye	Старый Мрачноглаз
Acidic Swamp Ooze	Кислотный слизнюк
Argent Commander	Командир Авангарда
Pint-Sized Summoner	Гном-призыватель
Secretkeeper	Хранительница тайн
Mad Bomber	Чокнутый подрывник
Tinkmaster Overspark	Мехмастер Замыкалец
Warsong Commander	Командир Песни Войны
Mind Control Tech	Ментальный техник
Arcane Golem	Чародейский голем
Cabal Shadow Priest	Жрица Тьмы
Defender of Argus	Защитник Аргуса
Gadgetzan Auctioneer	Гоблин-аукционист
Loot Hoarder	Собиратель сокровищ
Abomination	Поганище
Lorewalker Cho	Хранитель истории Чо
Demolisher	Разрушитель
Coldlight Seer	Вайш'ирский провидец
Mountain Giant	Горный великан
Cairne Bloodhoof	Кэрн Кровавое Копыто
Gelbin Mekkatorque	Гелбин Меггакрут
Leeroy Jenkins	Лирой Дженкинс
Eviscerate	Потрошение
Betrayal	Предательство
Conceal	Замаскировать
Fan of Knives	Веер клинков
Noble Sacrifice	Самопожертвование
Defias Ringleader	Главарь Братства
Eye for an Eye	Око за око
Perdition's Blade	Клинок вечных мук
SI:7 Agent	Агент ШРУ
Redemption	Искупление
Headcrack	Черепокол
Shadowstep	Шаг сквозь тень
Preparation	Подготовка
Wrath	Гнев
Mark of Nature	Знак природы
Soul of the Forest	Душа леса
Power of the Wild	Сила дикой природы
Naturalize	Близость к природе
Dire Wolf Alpha	Вожак лютых волков
Nourish	Дар природы
Druid of the Claw	Друид когтя
Keeper of the Grove	Хранитель чащи
Innervate	Озарение
Emperor Cobra	Императорская кобра
Starfire	Звездный огонь
Ancient of War	Древо войны
Lightning Bolt	Молния
Lava Burst	Выброс лавы
Dust Devil	Пыледемон
Totemic Might	Сила тотемов
Earth Shock	Земной шок
Hex	Сглаз
Stormforged Axe	Топор бури
Feral Spirit	Дух дикого волка
Baron Geddon	Барон Геддон
Earth Elemental	Элементаль земли
Forked Lightning	Раздвоенная молния
Unbound Elemental	Вольный элементаль
Lightning Storm	Гроза
Ethereal Arcanist	Эфириал-чародей
Cone of Cold	Конус холода
Arcane Missiles	Чародейские стрелы
Shiv	Отравляющий укол
Pyroblast	Огненная глыба
Frost Elemental	Ледяной элементаль
Azure Drake	Лазурный дракон
Counterspell	Антимагия
Ice Barrier	Ледяная преграда
Mirror Entity	Отраженная сущность
Ice Block	Ледяная глыба
Ragnaros the Firelord	Рагнарос
Felguard	Страж Скверны
Mortal Coil	Лик тлена
Shadowflame	Пламя Тьмы
Void Terror	Ужасень Бездны
Succubus	Суккуб
Soulfire	Ожог души
Siphon Soul	Вытягивание души
Doomguard	Страж ужаса
Twisting Nether	Круговерть Пустоты
Pit Lord	Владыка преисподней
Summoning Portal	Портал призыва
Power Overwhelming	Переполняющая мощь
Sense Demons	Чутье на демонов
Flame Imp	Огненный бес
Bane of Doom	Бич судьбы
Lord Jaraxxus	Лорд Джараксус
Silence	Немота
Shadow Madness	Темное безумие
Lightspawn	Порождение Света
Thoughtsteal	Украденные мысли
Lightwell	Колодец Света
Mindgames	Игры разума
Divine Favor	Божественная милость
Prophet Velen	Пророк Велен
Lay on Hands	Возложение рук
Blessed Champion	Благословение силы
Humility	Смирение
Argent Protector	Заступник Авангарда
Blessing of Wisdom	Печать мудрости
Holy Wrath	Гнев небес
Sword of Justice	Меч справедливости
Hand of Protection	Длань защиты
Repentance	Покаяние
Aldor Peacekeeper	Миротворец Алдоров
Tirion Fordring	Тирион Фордринг
Avenging Wrath	Гнев карателя
Tauren Warrior	Таурен-воин
Slam	Мощный удар
Battle Rage	Боевая ярость
Amani Berserker	Аманийский берсерк
Mogu'shan Warden	Стражник Могу'шан
Arathi Weaponsmith	Оружейница Арати
Gurubashi Berserker	Берсерк Гурубаши
Whirlwind	Вихрь
Armorsmith	Мастер брони
Shieldbearer	Щитоносец
Brawl	Потасовка
Mortal Strike	Смертельный удар
Upgrade!	Улучшение
Shield Slam	Мощный удар щитом
Gorehowl	Кровавый вой
Raging Worgen	Разъяренный ворген
Grommash Hellscream	Громмаш Адский Крик
Murloc Tidehunter	Мурлок-волнолов
Murloc Warleader	Мурлок-полководец
Grimscale Oracle	Оракул Темной Чешуи
Murloc Tidecaller	Мурлок-волномут
Patient Assassin	Терпеливый убийца
Scavenging Hyena	Гиена-падальщица
Misdirection	Перенаправление
Savannah Highmane	Высокогрив саванны
Eaglehorn Bow	Лук Орлиного рога
Explosive Shot	Разрывной выстрел
Unleash the Hounds	Спустить собак
Kill Command	Команда «Взять!»
King Krush	Король Круш
Flare	Осветительная ракета
Bestial Wrath	Звериный гнев
Snake Trap	Змеиная ловушка
Harvest Golem	Уборочный голем
Nat Pagle	Нат Пэгл
Harrison Jones	Харрисон Джонс
Archmage Antonidas	Архимаг Антонидас
Nozdormu	Ноздорму
Alexstrasza	Алекстраза
Onyxia	Ониксия
Malygos	Малигос
Faceless Manipulator	Безликий манипулятор
Flametongue Totem	Тотем языка пламени
Doomhammer	Молот Рока
Bite	Укус
Force of Nature	Сила природы
Ysera	Изера
Cenarius	Кенарий
Mana Tide Totem	Тотем прилива маны
The Beast	Чудовище
Savagery	Дикость
Sap	Ошеломление
Dalaran Mage	Маг Даларана
Priestess of Elune	Жрица Элуны
Ancient Mage	Древний маг
Sea Giant	Морской великан
Windspeaker	Говорящий с ветром
Blood Knight	Рыцарь крови
Auchenai Soulpriest	Аукенайская жрица
Nightblade	Ночной Клинок
Vaporize	Обращение в пар
Cult Master	Глава культа
Demonfire	Демонический огонь
Imp Master	Владычица бесов
Cruel Taskmaster	Злой надсмотрщик
Frothing Berserker	Разъяренный берсерк
Shield Block	Блок щитом
Inner Rage	Внутренняя ярость
Sorcerer's Apprentice	Ученица чародея
Snipe	Снайперский выстрел
Explosive Trap	Взрывная ловушка
Freezing Trap	Морозная ловушка
Kirin Tor Mage	Маг Кирин-Тора
Edwin VanCleef	Эдвин ван Клиф
Illidan Stormrage	Иллидан Ярость Бури
Mana Wraith	Магический призрак
Deadly Shot	Смертельный выстрел
Equality	Равенство
Molten Giant	Огненный великан
Circle of Healing	Круг исцеления
Shadow Word: Death	Слово Тьмы: Смерть
Temple Enforcer	Храмовый боец
Holy Fire	Священный огонь
Shadowform	Облик Тьмы
Mass Dispel	Массовое рассеивание
Zombie Chow	Вкусный зомби
Haunted Creeper	Одержимый ползун
Echoing Ooze	Делящийся слизнюк
Mad Scientist	Безумный ученый
Shade of Naxxramas	Тень Наксрамаса
Nerubian Egg	Нерубское яйцо
Spectral Knight	Призрачный рыцарь
Deathlord	Владыка Смерти
Maexxna	Мексна
Webspinner	Тенетник
Sludge Belcher	Изрыгатель слизи
Kel'Thuzad	Кел'Тузад
Stalagg	Сталагг
Feugen	Фойген
Wailing Soul	Стенающая душа
Nerub'ar Weblord	Властелин паутины
Duplicate	Раздвоение
Poison Seeds	Ядовитые семена
Avenge	Отмщение
Death's Bite	Укус смерти
Voidcaller	Призыватель Бездны
Dark Cultist	Темный сектант
Unstable Ghoul	Нестабильный вурдалак
Reincarnate	Возрождение
Anub'ar Ambusher	Неруб-душитель
Stoneskin Gargoyle	Каменная горгулья
Undertaker	Могильщик
Dancing Swords	Танцующие клинки
Loatheb	Лотхиб
Baron Rivendare	Барон Ривендер
Flamecannon	Огненная пушка
Snowchugger	Снегочух
Unstable Portal	Нестабильный портал
Goblin Blastmage	Гоблин-взрывомаг
Echo of Medivh	Эхо Медива
Mechwarper	Механосборщик
Flame Leviathan	Огненный левиафан
Lightbomb	Световая бомба
Shadowbomber	Теневой бомбардир
Velen's Chosen	Избранник Велена
Shrinkmeister	Уменьшайстер
Light of the Naaru	Свет Наару
Cogmaster	Мастер шестеренок
Vol'jin	Вол'джин
Darkbomb	Темная бомба
Fel Reaver	Сквернобот
Call Pet	Призыв питомца
Mistress of Pain	Госпожа Боли
Demonheart	Сердце демона
Fel Cannon	Пушка Скверны
Mal'Ganis	Мал'Ганис
Tinker's Sharpsword Oil	Оружейное механомасло
Goblin Auto-Barber	Авто-брадобрей
Cogmaster's Wrench	Гаечный ключ
One-eyed Cheat	Одноглазый плут
Feign Death	Притвориться мертвым
Iron Sensei	Железный сенсей
Trade Prince Gallywix	Принц Галливикс
Ancestor's Call	Зов предков
Anodized Robo Cub	Ржавый медвежонок
Recycle	Переработка
Grove Tender	Хранительница рощи
Tree of Life	Древо Жизни
Mech-Bear-Cat	Механо-медвекот
Malorne	Малорн
Powermace	Палица силы
Whirling Zap-o-matic	Крутящийся меченосец
Crackle	Разряд
Vitality Totem	Тотем жизни
Siltfin Spiritwalker	Мурлок-духостранник
Dark Wispers	Мрачный огонек
Neptulon	Нептулон
Glaivezooka	Метатель глеф
Spider Tank	Танк-паук
Imp-losion	Бес-пощадный взрыв
King of Beasts	Царь зверей
Sabotage	Диверсия
Metaltooth Leaper	Железнозубый прыгун
Gahz'rilla	Газ'рилла
Bouncing Blade	Прыгучий сюрикэн
Warbot	Боевой робот
Crush	Сокрушение
Shieldmaiden	Защитница
Ogre Warmaul	Боевой молот огров
Screwjank Clunker	Ржавый голем
Iron Juggernaut	Железный исполин
Seal of Light	Печать Света
Shielded Minibot	Защищенный мини-бот
Coghammer	Зубцевик
Quartermaster	Интендант
Muster for Battle	Призыв в бой
Cobalt Guardian	Кобальтовый страж
Bolvar Fordragon	Болвар Фордрагон
Puddlestomper	Грязевик
Ogre Brute	Огр-громила
Dunemaul Shaman	Огр-шаман
Stonesplinter Trogg	Трогг Камнедробов
Burly Rockjaw Trogg	Трогг Каменной Челюсти
Antique Healbot	Древний исцелятор
Salty Dog	Просоленный моряк
Lost Tallstrider	Заблудившийся долгоног
Shadowboxer	Теневой боксер
Cobra Shot	Выстрел кобры
Kezan Mystic	Мистик Кезана
Ship's Cannon	Корабельная пушка
Explosive Sheep	Взрывоопасная овца
Anima Golem	Голем Анимуса
Mechanical Yeti	Механический йети
Force-Tank MAX	Силовой танк
Druid of the Fang	Друид-змея
Gilblin Stalker	Жаблин-ловец
Clockwork Gnome	Заводной гном
Upgraded Repair Bot	Ремонтный супербот
Flying Machine	Ветролет
Annoy-o-Tron	Раздражатор
Siege Engine	Осадная машина
Steamwheedle Sniper	Снайпер из картеля
Ogre Ninja	Огр-ниндзя
Illuminator	Просветительница
Madder Bomber	Ошалевший подрывник
Arcane Nullifier X-21	Чудо-обнулятор X-21
Gnomish Experimenter	Гном-экспериментатор
Target Dummy	Манекен-мишень
Jeeves	Дживс
Goblin Sapper	Гоблин-сапер
Piloted Shredder	Пилотируемый крошшер
Lil' Exorcist	Юный экзорцист
Gnomeregan Infantry	Пехотинец Гномрегана
Bomb Lobber	Бомбометатель
Floating Watcher	Парящий страж
Scarlet Purifier	Освятитель Алого ордена
Tinkertown Technician	Гном-техник
Micro Machine	Микроробот
Hobgoblin	Хобгоблин
Piloted Sky Golem	Небесный голем
Junkbot	Хламобот
Enhance-o Mechano	Механо-усилитель
Recombobulator	Рекомбинатор
Mini-Mage	Мини-маг
Dr. Boom	Доктор Бум
Mimiron's Head	Голова Мимирона
Mogor the Ogre	Огр Могор
Foe Reaper 4000	Врагорез-4000
Sneed's Old Shredder	Старый крошшер Снида
Toshley	Тошли
Mekgineer Thermaplugg	Анжинер Термоштепсель
Gazlowe	Газлоу
Troggzor the Earthinator	Троггзор Терранатор
Blingtron 3000	Блескотрон-3000
Hemet Nesingwary	Хеминг Эрнестуэй
Clockwork Giant	Заводной великан
Wee Spellstopper	Контрзаклинательница
Soot Spewer	Изрыгатель сажи
Garrosh Hellscream	Гаррош Адский Крик
Magni Bronzebeard	Магни Бронзобород
Thrall	Тралл
Morgl the Oracle	Оракул Моргл
Valeera Sanguinar	Валира Сангвинар
Maiev Shadowsong	Майев Песнь Теней
Uther Lightbringer	Утер Светоносный
Lady Liadrin	Леди Лиадрин
Prince Arthas	Принц Артас
Rexxar	Рексар
Alleria Windrunner	Аллерия Ветрокрылая
Malfurion Stormrage	Малфурион
Gul'dan	Гул'дан
Nemsy Necrofizzle	Немси Некропшик
Jaina Proudmoore	Джайна Праудмур
Medivh	Медив
Khadgar	Кадгар
Anduin Wrynn	Андуин Ринн
Tyrande Whisperwind	Тиранда Шелест Ветра
Phantom Freebooter	Призрачный корсар
Skelemancer	Скелемант
Exploding Bloatbat	Взрывной нетопырь
Snowflipper Penguin	Снежный прыгвин
Rattling Rascal	Костяной плут
Grim Necromancer	Мрачный некромант
Bone Drake	Костяной дракон
Sunborne Val'kyr	Светозарная валь'кира
Cobalt Scalebane	Кобальтовый губитель
Night Howler	Ночной завыватель
Venomancer	Ядомант
Arrogant Crusader	Надменный рыцарь
Righteous Protector	Праведная защитница
Dark Conviction	Неправедный суд
Defile	Осквернение
Fatespinner	Пряха Судьбы
Toxic Arrow	Токсичная стрела
Webweave	Паутина
Druid of the Swarm	Друид-роевик
Play Dead	Ложная смерть
Spreading Plague	Ползучая чума
Drain Soul	Похищение души
Cryostasis	Криостаз
Brrrloc	Брррлок
Mountainfire Armor	Пламенеющий доспех
Blood Razor	Кровавый клинок
Bone Baron	Повелитель костей
Vryghoul	Врайдалак
Ice Walker	Ледяной ходок
Ghastly Conjurer	Жуткая кудесница
Light's Sorrow	Скорбь Света
Despicable Dreadlord	Гадкий натрезим
Avalanche	Лавина
Gnash	Мертвая хватка
Drakkari Defender	Защитник драккари
Frozen Clone	Ледяные двойники
Doomed Apprentice	Обреченная ученица
Ultimate Infestation	Тотальное заражение
Glacial Mysteries	Ледяные загадки
Voodoo Hexxer	Проклинательница
Ice Fishing	Подледная ловля
Snowfury Giant	Снежный великан
Dead Man's Hand	Рука мертвеца
Acherus Veteran	Ветеран Акеруса
Tuskarr Fisherman	Клыкарр-рыболов
Fallen Sun Cleric	Падшая син'дорай
Furnacefire Colossus	Тигельный колосс
Grave Shambler	Могильный громадень
Tomb Lurker	Могильный скрытень
Ticking Abomination	Тикающее поганище
Venomstrike Trap	Ядовитая ловушка
Roll the Bones	Бросок костей
Professor Putricide	Профессор Мерзоцид
Treachery	Вероломство
Devour Mind	Пожирание разума
Shadow Ascendant	Прислужница Тени
Acolyte of Agony	Служитель агонии
Eternal Servitude	Вечное служение
Obsidian Statue	Обсидиановая статуя
Archbishop Benedictus	Архиепископ Бенедикт
Howlfiend	Воющая тварь
Deadscale Knight	Рыцарь Мертвожабрых
Leeching Poison	Похищающий жизнь яд
Doomerang	Умеранг
Shadow Essence	Сущность тени
Ice Breaker	Ледорез
Animated Berserker	Оживленный берсерк
Runeforge Haunter	Рунный упырь
Corpse Widow	Трупная вдова
Desperate Stand	До последнего вздоха
Blackguard	Черный страж
Coldwraith	Хладный дух
Corpse Raiser	Воскреситель мертвых
Forge of Souls	Кузня Душ
Moorabi	Мураби
The Lich King	Король-лич
Rotface	Гниломорд
Gnomeferatu	Гномферату
Val'kyr Soulclaimer	Похитительница душ
Stitched Tracker	Заштопанный следопыт
Bearshark	Медвекула
Death Revenant	Загробный гость
Saronite Chain Gang	Дренеи-каторжники
Deathspeaker	Вестница смерти
Wretched Tiller	Проклятый фермер
Unwilling Sacrifice	Невольная жертва
Thrall, Deathseer	Провидец смерти Тралл
Happy Ghoul	Веселый вурдалак
Skulking Geist	Крадущийся упырь
Shallow Gravedigger	Гробокопательница
Bonemare	Костяная кобыла
Nerubian Unraveler	Нерубский мастер сетей
Howling Commander	Воющий командир
Spirit Lash	Астральная плеть
Strongshell Scavenger	Крепкий мародер
Crypt Lord	Владыка склепа
Plague Scientist	Исследователь чумы
Deathaxe Punisher	Каратель с топором
Lilian Voss	Лилиан Восс
Meat Wagon	Мясной фургон
Chillblade Champion	Рыцарь Ледяного Клинка
Simulacrum	Симулякр
Abominable Bowman	Поганый стрелок
Valeera the Hollow	Валира Иссохшая
Deathstalker Rexxar	Ловчий смерти Рексар
Uther of the Ebon Blade	Утер Черный Клинок
Shadowreaper Anduin	Темный жнец Андуин
Bloodreaver Gul'dan	Кровопийца Гул'дан
Malfurion the Pestilent	Малфурион Пагубный
Frost Lich Jaina	Ледяной лич Джайна
Scourgelord Garrosh	Владыка Плети Гаррош
Hadronox	Хадронокс
Breath of Sindragosa	Дыхание Синдрагосы
Bring It On!	Кто на меня?!
Sindragosa	Синдрагоса
Blood-Queen Lana'thel	Королева Лана'тель
Embrace Darkness	Темные объятия
Shadowblade	Теневой клинок
Prince Keleseth	Принц Келесет
Prince Taldaram	Принц Талдарам
Prince Valanar	Принц Валанар
Arfus	Псартас
Hyldnir Frostrider	Хильдская всадница
Spellweaver	Прядильщица чар
Bolvar, Fireblood	Болвар Опаленный
Necrotic Geist	Некротический упырь
Drakkari Enchanter	Чародейка драккари
Mindbreaker	Сокрушитель разума
Sanguine Reveler	Кровавый гедонист
Wicked Skeleton	Злобный скелет
Bloodworm	Кровавый червь
Spectral Pillager	Вороватый дух
Keening Banshee	Голосящая банши
Corpsetaker	Похитительница трупов
Tainted Zealot	Нечестивый фанатик
Cat Trick	Фокус-котус
Kindly Grandmother	Бабушка
Cloaked Huntress	Скрытная охотница
Babbling Book	Болтливая книга
Nightbane Templar	Страж Ночной Погибели
Pompous Thespian	Напыщенный актер
Purify	Очищение
Wicked Witchdoctor	Злая колдунья
Kara Kazham!	Сим-каражим!
Protect the King!	Спасай короля!
Fool's Bane	Несчастье шута
Runic Egg	Руническое яйцо
Pantry Spider	Буфетный паучок
Book Wyrm	Книгозмей
Priest of the Feast	Жрец-обжора
Arcane Anomaly	Волшебная аномалия
Avian Watcher	Пернатый страж
Moat Lurker	Канавный скрытень
Moroes	Мороуз
Ivory Knight	Белый конь
The Curator	Смотритель
Netherspite Historian	Историк Гнева Пустоты
Spirit Claws	Призрачные когти
Menagerie Warden	Зверовод
Swashburglar	Пират-пройдоха
Ethereal Peddler	Эфириал-торговец
Maelstrom Portal	Портал: Водоворот
Moonglade Portal	Портал: Лунная поляна
Firelands Portal	Портал: Огненные Просторы
Silvermoon Portal	Портал: Луносвет
Malchezaar's Imp	Бес Малчезара
Ironforge Portal	Портал: Стальгорн
Medivh's Valet	Лакей Медива
Deadly Fork	Острая вилка
Zoobot	Зообот
Prince Malchezaar	Принц Малчезар
Medivh, the Guardian	Хранитель Медив
Barnes	Барнс
Onyx Bishop	Черный слон
Silverware Golem	Посудный голем
Enchanted Raven	Колдовской ворон
Menagerie Magician	Зверомаг
Arcanosmith	Волшебный кузнец
Arcane Giant	Волшебный великан
Violet Illusionist	Иллюзионистка
Forgotten Torch	Забытый факел
Ethereal Conjurer	Кудесник-эфириал
Museum Curator	Смотритель музея
Curse of Rafaam	Проклятие Рафаама
Obsidian Destroyer	Обсидиановый крушитель
Pit Snake	Гадюка
Reno Jackson	Рено Джексон
Tomb Pillager	Расхититель гробниц
Rumbling Elemental	Гремящий элементаль
Keeper of Uldaman	Хранитель Ульдамана
Tunnel Trogg	Туннельный трогг
Unearthed Raptor	Ископаемый ящер
Desert Camel	Пустынный верблюд
Dart Trap	Ловушка с дротиками
Fierce Monkey	Яростная макака
Dark Peddler	Черный археолог
Anyfin Can Happen	Мурглвратности судьбы
Sacred Trial	Священный суд
Jeweled Scarab	Драгоценный скарабей
Naga Sea Witch	Морская ведьма
Gorillabot A-3	Гориллабот А-3
Huge Toad	Огромная жаба
Tomb Spider	Могильный паук
Mounted Raptor	Ездовой ящер
Jungle Moonkin	Тропический совух
Djinni of Zephyrs	Джинн ветров
Anubisath Sentinel	Анубисат-часовой
Fossilized Devilsaur	Окаменелый дьявозавр
Sir Finley Mrrgglton	Сэр Финли Мрргглтон
Brann Bronzebeard	Бранн Бронзобород
Elise Starseeker	Элиза Звездочет
Summoning Stone	Камень призыва
Wobbling Runts	Башня из пигмеев
Arch-Thief Rafaam	Великий вор Рафаам
Entomb	Погребение
Explorer's Hat	Шляпа исследователя
Eerie Statue	Зловещая статуя
Ancient Shade	Древняя тень
Excavated Evil	Раскопанное зло
Everyfin is Awesome	Все у нас мррглклассно!
Raven Idol	Статуя ворона
Reliquary Seeker	Искательница Реликвария
Cursed Blade	Проклятый клинок
Animated Armor	Оживленные доспехи
Murloc Tinyfin	Малый Плавник
Psychic Scream	Ментальный крик
Vulgar Homunculus	Грубый гомункул
Kobold Librarian	Кобольд-библиотекарь
Dark Pact	Темный пакт
Hooked Reaver	Крюконосец-разоритель
Fal'dorei Strider	Фал'дорайский странник
Cavern Shinyfinder	Пещерная блестяшница
Kobold Barbarian	Кобольд-варвар
Lesser Amethyst Spellstone	Оберег: малый аметист
Bladed Gauntlet	Длань-клинок
Barkskin	Дубовая кожа
Ironwood Golem	Голем из древостали
Lesser Jasper Spellstone	Оберег: малая яшма
Branching Paths	Развилка
Astral Tiger	Астральный тигр
Crushing Hand	Сокрушающая длань
Kobold Hermit	Кобольд-отшельник
Lesser Sapphire Spellstone	Оберег: малый сапфир
Sewer Crawler	Обитатель стоков
Flanking Strike	Обходной удар
Cave Hydra	Пещерная гидра
Wandering Monster	Блуждающий монстр
Lesser Emerald Spellstone	Оберег: малый изумруд
Rhok'delar	Рок'делар
Potion of Heroism	Зелье героизма
Lesser Pearl Spellstone	Оберег: малая жемчужина
Call to Arms	К оружию!
Explosive Runes	Взрывающиеся руны
Lesser Ruby Spellstone	Оберег: малый рубин
Shifting Scroll	Свиток-перевертыш
Deck of Wonders	Колода чудес
Aluneth	Алунет
Scorp-o-matic	Скорпобот
Wax Elemental	Восковой элементаль
Ebon Dragonsmith	Дракон-кузнец
Corrosive Sludge	Едкий слизнюк
Lone Champion	Герой-одиночка
Stoneskin Basilisk	Камнекожий василиск
Arcane Tyrant	Магический деспот
Green Jelly	Зеленое желе
Dragonslayer	Убийца драконов
Toothy Chest	Зубастый сундук
Sneaky Devil	Демон-проныра
Sleepy Dragon	Спящая драконица
Hoarding Dragon	Запасливый дракон
Corridor Creeper	Коридорный ужас
Furbolg Mossbinder	Фурболг-мохомант
Boisterous Bard	Громкоголосый бард
Violet Wurm	Лиловый червь
Gravelsnout Knight	Камнерыл-рыцарь
Carnivorous Cube	Плотоядный куб
Sonya Shadowdancer	Соня Тенепляс
Fungalmancer	Грибомант
Raven Familiar	Ворон-фамилиар
Dragon's Fury	Ярость дракона
Silver Vanguard	Стражница авангарда
Twilight's Call	Зов сумерек
Shimmering Courser	Мерцающий скакун
Lesser Mithril Spellstone	Оберег: малый мифрил
Cheat Death	Обман смерти
Dragon Soul	Душа дракона
Sudden Betrayal	Внезапное предательство
Elven Minstrel	Эльф-менестрель
Evasion	Ускользание
Lynessa Sunsorrow	Линесса Печаль Солнца
To My Side!	Ко мне!
Feral Gibberer	Дикий бормотун
Candleshot	Свечкострел
Arcane Artificer	Магический бронник
Cursed Disciple	Проклятый ученик
Dire Mole	Жуткий крот
Unidentified Elixir	Неопознанный эликсир
Unidentified Shield	Неопознанный щит
Unidentified Maul	Неопознанный молот
Shroom Brewer	Грибовар
Possessed Lackey	Одержимый лакей
Oaken Summons	Зов чащобы
Crystal Lion	Хрустальный лев
Grizzled Guardian	Косолапый страж
Trogg Gloomeater	Трогг-мрачноед
Ixlid, Fungal Lord	Архигриб Икслид
Level Up!	Новый уровень!
Primal Talismans	Талисманы стихий
Kobold Apprentice	Кобольд-адепт
Greedy Sprite	Жадный дух
Psionic Probe	Псионный зонд
Marin the Fox	Марин Лис
Grumble, Worldshaker	Грамбл, сотрясатель миров
Drygulch Jailor	Кобольд-тюремщик
Reckless Flurry	Шквал гнева
Gemstudded Golem	Инкрустированный голем
Drywhisker Armorer	Сухоус-бронник
Voidlord	Повелитель Бездны
Gather Your Party	Всей группой!
Healing Rain	Целительный ливень
Guild Recruiter	Вербовщица гильдии
Woecleaver	Бедоруб
Kobold Monk	Кобольд-монах
Hungry Ettin	Голодный эттин
Fungal Enchanter	Гриб-чародел
Rummaging Kobold	Кобольд-барахольщик
Twig of the World Tree	Ветвь Древа Жизни
Shrieking Shroom	Визжащий гриб
Benevolent Djinn	Великодушный джинн
Duskbreaker	Вестник заката
Kobold Illusionist	Кобольд-иллюзионист
Plated Beetle	Бронированный жук
Grand Archivist	Великий архивариус
Rin, the First Disciple	Первоученица Рин
Cataclysm	Катаклизм
Skull of the Man'ari	Череп Ман'ари
Val'anyr	Вал'анир
Lesser Onyx Spellstone	Оберег: малый оникс
Unstable Evolution	Изменчивая эволюция
The Runespear	Рунное копье
Lesser Diamond Spellstone	Оберег: малый алмаз
Kathrena Winterwisp	Катрена Зимний Шорох
Zola the Gorgon	Зола Горгона
Murmuring Elemental	Рокочущий элементаль
Windshear Stormcaller	Ветрорез-призыватель
Geosculptor Yip	Геоскульптор Йип
Seeping Oozeling	Журчащий слизнюченыш
Master Oakheart	Мастер Сердцедуб
Crushing Walls	Сокрушающие стены
The Darkness	Тьма
Twilight Acolyte	Сумеречный послушник
Void Ripper	Потрошитель Бездны
Gilded Gargoyle	Золоченая горгулья
Dragoncaller Alanna	Дракономант Аланна
Leyline Manipulator	Элементаль-манипулятор
Temporus	Темпорус
Spiteful Summoner	Злая призывательница
Dragonhatcher	Драконозаводчик
King Togwaggle	Король Вихлепых
Kingsbane	Погибель королей
Sacrificial Pact	Жертвенный договор
Vanish	Исчезновение
Kidnapper	Похититель
Starfall	Звездопад
Ancient of Lore	Древо мудрости
Al'Akir the Windlord	Ал'акир
Kor'kron Elite	Кор'кронский воин
Mana Wyrm	Маназмей
Master of Disguise	Мастер маскировки
Captain's Parrot	Попугай капитана
Hungry Crab	Голодный краб
Bloodsail Raider	Дерзкая налетчица
Knife Juggler	Жонглер кинжалами
Wild Pyromancer	Яростный пиромант
Doomsayer	Вестник рока
Dread Corsair	Жуткий корсар
Faerie Dragon	Чудесный дракончик
Captain Greenskin	Капитан Зеленямс
Bloodsail Corsair	Кровожадный корсар
Violet Teacher	Учительница магии
Southsea Captain	Капитан Южных морей
Millhouse Manastorm	Миллхаус Манашторм
Deathwing	Смертокрыл
Animal Companion	Питомец
Commanding Shout	Командирский крик
Master Swordsmith	Мастер ковки клинков
Gruul	Груул
Hogger	Дробитель
Stampeding Kodo	Несущийся кодо
Vilefin Inquisitor	Мурквизитор
Primal Fusion	Сила стихий
Flamewreathed Faceless	Пламенный безликий
Eternal Sentinel	Вечный страж
Evolve	Эволюция
Thing from Below	Нечто из глубин
Hammer of Twilight	Молот Сумерек
Tentacles for Arms	Цепкие щупальца
Silithid Swarmer	Силитид-членистоног
Y'Shaarj, Rage Unbound	И'Шарадж
Fandral Staghelm	Фэндрал Олений Шлем
Infest	Заражение
Feral Rage	Звериное неистовство
Mark of Y'Shaarj	Метка И'Шараджа
Forbidden Ancient	Запретное древо
On the Hunt	Охота
Bladed Cultist	Сектант-убийца
Journey Below	Путь через глубины
Thistle Tea	Скорополоховый чай
Xaril, Poisoned Mind	Ксарил
Shatter	Раскол
Evolved Kobold	Мутировавший кобольд
Twilight Flamecaller	Сумеречный пиромант
Demented Frostcaller	Безумный служитель льда
Forbidden Flame	Запретное пламя
Servant of Yogg-Saron	Слуга Йогг-Сарона
Cabalist's Tome	Фолиант заговорщика
Power Word: Tentacles	Слово силы: Щупальца
Twilight Darkmender	Сумеречная целительница
Shadow Word: Horror	Слово Тьмы: Ужас
Forbidden Shaping	Запретная форма
Darkspeaker	Темный проповедник
Embrace the Shadow	Объятия Тьмы
Darkshire Librarian	Библиотекарь Темнолесья
Darkshire Councilman	Член совета Темнолесья
Forbidden Ritual	Запретный ритуал
Spreading Madness	Заразительное безумие
Renounce Darkness	Отречение от Тьмы
Anomalus	Аномалус
Cho'gall	Чо'Галл
Mukla, Tyrant of the Vale	Мукла, Гроза Долины
Shifter Zerus	Оборотень Зерус
Twin Emperor Vek'lor	Император Век'лор
N'Zoth, the Corruptor	Н'Зот
Yogg-Saron, Hope's End	Йогг-Сарон
Nerubian Prophet	Нерубский пророк
Faceless Behemoth	Безликий гигант
Eldritch Horror	Зловещий ужас
Psych-o-Tron	Психонатор
Corrupted Healbot	Оскверненный исцелятор
Ravaging Ghoul	Буйный вурдалак
Aberrant Berserker	Искаженный берсерк
Tentacle of N'Zoth	Щупальце Н'Зота
Grotesque Dragonhawk	Уродливый дракондор
Bog Creeper	Болотный ползун
Bilefin Tidehunter	Порочный волнолов
Zealous Initiate	Ревностный аколит
Corrupted Seer	Падший провидец
Disciple of C'Thun	Поборник К'Туна
Blood of The Ancient One	Кровь Древнего
Faceless Shambler	Безликий шаркун
Shadow Strike	Теневой удар
Fiery Bat	Огненный нетопырь
Klaxxi Amber-Weaver	Прядильщик клакси
Wisps of the Old Gods	Древние огоньки
Forbidden Healing	Запретное исцеление
Validated Doomsayer	Вестник доказанного рока
Mire Keeper	Хранитель болот
Stormcrack	Удар молнии
Faceless Summoner	Безликий призыватель
Hallazeal the Ascended	Халлазил Перерожденный
Call of the Wild	Зов лесов
Infested Wolf	Зараженный волк
Bloodhoof Brave	Храбрец Кровавого Копыта
Malkorok	Малкорок
Selfless Hero	Самоотверженная героиня
Rallying Blade	Объединяющий клинок
Divine Strength	Божественная сила
Ragnaros, Lightlord	Рагнарос Слуга Света
Darkshire Alchemist	Алхимик Темнолесья
DOOM!	Погибель!
Possessed Villager	Одержимый крестьянин
Twisted Worgen	Искаженный ворген
Am'gam Rager	Яростень Ам'гам
Infested Tauren	Зараженный таурен
Eater of Secrets	Пожиратель секретов
Doomcaller	Призыватель Рока
Spawn of N'Zoth	Порождение Н'Зота
Southsea Squidface	Кальмарный пират
Scaled Nightmare	Чешуйчатый кошмар
Twilight Summoner	Сумеречный призыватель
Stand Against Darkness	Преграда на пути Тьмы
Blood Warriors	Кровавые воины
C'Thun	К'Тун
Beckoner of Evil	Зовущая Зло
Blade of C'Thun	Клинок К'Туна
C'Thun's Chosen	Избранница К'Туна
Twilight Geomancer	Сумеречный геомант
Twilight Elder	Сумеречный предок
Ancient Harbinger	Древняя предвестница
Shadowcaster	Темная чародейка
Forlorn Stalker	Одинокий охотник
Dark Arakkoa	Темный араккоа
Cult Apothecary	Аптекарь-сектант
The Boogeymonster	Букамонстр
Ancient Shieldbearer	Древний щитоносец
Usher of Souls	Привратница душ
Cult Sorcerer	Колдунья-сектантка
Giant Sand Worm	Огромный песчаный червь
Princess Huhuran	Принцесса Хухуран
Steward of Darkshire	Распорядитель Темнолесья
A Light in the Darkness	Свет во Тьме
N'Zoth's First Mate	Первый помощник Н'Зота
Addled Grizzly	Обезумевший гризли
Blood To Ichor	Кровь и гной
Bloodsail Cultist	Пират-сектантка
Herald Volazj	Глашатай Волаж
Deathwing, Dragonlord	Владыка Смертокрыл
Hogger, Doom of Elwynn	Кошмарный Дробитель
Midnight Drake	Полночный дракон
Crazed Worshipper	Безумный служитель
Blackwater Pirate	Пират Черноводья
Polluted Hoarder	Грязный барахольщик
Carrion Grub	Личинка-падальщик
Duskboar	Темный вепрь
Squirming Tentacle	Извивающееся щупальце
Master of Evolution	Мастер эволюции
Undercity Huckster	Торговец из Подгорода
Hooded Acolyte	Скрытная послушница
Shifting Shade	Изменчивая тень
Cyclopian Horror	Одноглазый ужас
Nat, the Darkfisher	Нат, Темный Рыболов
Skeram Cultist	Сектант Скерама
Soggoth the Slitherer	Соггот
Elite Tauren Chieftain	E.T.C.
Flesheating Ghoul	Плотоядный вурдалак
Spellbender	Чароплет
Pterrordax Hatchling	Птенец терродактиля
Volcanosaur	Вулканозавр
Dinosize	Динозаврение
Ravasaur Runt	Малыш-равазавр
Sated Threshadon	Сытый жесткозуб
Hydrologist	Гидролог
Sunkeeper Tarim	Хранитель Солнца Тарим
Flame Geyser	Огненный гейзер
Air Elemental	Элементаль воздуха
Arcanologist	Арканолог
Steam Surger	Паровая туча
Mirage Caller	Призыватель миражей
Mana Bind	Узы маны
Volcano	Вулкан
Pyros	Пирос
Open the Waygate	Связующая спираль
Shadow Visions	Темные видения
Binding Heal	Связующее исцеление
Crystalline Oracle	Кристаллический оракул
Radiant Elemental	Сияющий элементаль
Curious Glimmerroot	Чудной сверкорень
Tortollan Shellraiser	Тортолльская стражница
Ravenous Pterrordax	Ненасытный терродактиль
Tar Lurker	Смоляной скрытень
Razorpetal Volley	Шквал остроцветов
Razorpetal Lasher	Колкий остроцвет
Mimic Pod	Мимикрия
Obsidian Shard	Обсидиановый осколок
Biteweed	Кусачник
Vilespine Slayer	Кровожадный злолист
Sherazin, Corpse Flower	Шеразин
The Caverns Below	Подземные пещеры
Tol'vir Stoneshaper	Тол'вирский камнемаг
Giant Mastodon	Огромный мастодонт
Stonehill Defender	Защитник холмов
Rockpool Hunter	Озерный охотник
Vicious Fledgling	Коварный птенец
Eggnapper	Яйцекрад
Tortollan Forager	Тортолльская сборщица
Frozen Crusher	Ледяной сокрушитель
Thunder Lizard	Рокочущий ящер
Devilsaur Egg	Яйцо дьявозавра
Fire Plume Phoenix	Феникс Огненного Венца
Emerald Hive Queen	Изумрудная королева
Giant Anaconda	Огромная анаконда
Bittertide Hydra	Гидра Горьких Волн
Tortollan Primalist	Тортолльская шаманка
Gentle Megasaur	Кроткий мегазавр
Charged Devilsaur	Заряженный дьявозавр
Verdant Longneck	Зеленое длинношеее
Shellshifter	Перевертыш
Evolving Spores	Споры роста
Earthen Scales	Земляная чешуя
Elder Longneck	Древнее длинношеее
Living Mana	Живая мана
Bright-Eyed Scout	Зоркая разведчица
Jungle Giants	Исполины джунглей
Primalfin Totem	Тотем палеомурлоков
Fire Plume Harbinger	Вестник Огненного Венца
Glacial Shard	Ледниковый осколок
Stone Sentinel	Каменный часовой
Kalimos, Primal Lord	Калимос Первородный
Terrorscale Stalker	Ловчий злобноплав
Nesting Roc	Рух-наседка
Emerald Reaver	Изумрудный разоритель
Ultrasaur	Ультразавр
Golakka Crawler	Ползун Голакка
Stubborn Gastropod	Упрямый брюхоног
Fire Fly	Огневичок
Stegodon	Стегодон
Sabretooth Stalker	Хищный саблезуб
Stormwatcher	Страж бурь
Giant Wasp	Гигантская оса
Servant of Kalimos	Слуга Калимоса
Tidal Surge	Гнев прилива
Volatile Elemental	Нестабильный элементаль
Envenom Weapon	Отравленное оружие
Lakkari Sacrifice	Жертва Лаккари
Cruel Dinomancer	Жестокий диномант
Corrupting Mist	Пелена порчи
Bloodbloom	Кроволист
Lakkari Felhound	Гончая Лаккари
Feeding Time	Налетай!
Chittering Tunneler	Стрекочущий землерой
Clutchmother Zavas	Королева Завас
Tar Lord	Смоляной дух
Hemet, Jungle Hunter	Охотник Хеминг
The Voraxx	Воракс
Humongous Razorleaf	Исполинский бритволист
Igneous Elemental	Пылкий элементаль
Shimmering Tempest	Проблеск бури
Blazecaller	Вестник зарева
Primordial Drake	Доисторический дракон
Elise the Trailblazer	Первопроходец Элиза
Tyrantus	Тирантий
Free From Amber	Нечто из янтаря
Hallucination	Иллюзия
Spiritsinger Umbra	Волхвица Умбра
Ozruk	Озрук
Grievous Bite	Болезненный укус
Jeweled Macaw	Самоцветный ара
Tol'vir Warden	Тол'вирский часовой
Raptor Hatchling	Детеныш ящера
Crackling Razormaw	Искрящий острозуб
Stampede	Дикий гон
Dinomancy	Диномантия
Swamp King Dred	Король болот Дред
The Marsh Queen	Королева болот
Explore Un'Goro	Изучение Ун'Горо
Iron Hide	Железная шкура
Ornery Direhorn	Злой дикорог
Cornered Sentry	Разведчица в беде
Sudden Genesis	Внезапногенез
Tar Creeper	Смоляной страж
Molten Blade	Клинок из лавы
King Mosh	Король Мош
Fire Plume's Heart	Сердце Огненного Венца
Primalfin Lookout	Палеомурлок-разведчик
Hot Spring Guardian	Страж гейзера
Awaken the Makers	Пробуждение творцов
Primordial Glyph	Петроглиф
Unite the Murlocs	Мурлочий союз
Gluttonous Ooze	Прожорливая слизь
Molten Reflection	Копия из лавы
Vinecleaver	Лозоруб
Spikeridged Steed	Гребнистый скакун
Primalfin Champion	Палеомурлок-защитник
The Last Kaleidosaur	Последний калейдозавр
Meteor	Метеорит
Spirit Echo	Отголоски духов
Direhorn Hatchling	Детеныш дикорога
Lost in the Jungle	Заблудившиеся в джунглях
Adaptation	Адаптация
Lightfused Stegodon	Сияющий стегодон
Lyra the Sunshard	Лира Осколок Солнца
